Row Labels,Lives rent free,Owned: Owns outright,Owned: Owns with a mortgage or loan,Private rented: Other private rented,Private rented: Private landlord or letting agency,Shared ownership: Shared ownership,Social rented: Other social rented,Social rented: Rents from council or Local Authority,Grand Total
E00073143,0,41,50,8,34,5,6,4,148
E00073145,1,11,12,4,61,0,42,27,158
E00073147,0,41,45,5,40,0,30,10,171
E00073148,0,11,12,3,77,1,29,9,142
E00073150,1,39,50,4,45,1,27,24,191
E00073152,0,43,59,5,35,1,0,1,144
E00073153,0,63,64,6,52,0,6,6,197
E00073154,0,44,67,2,17,0,0,0,130
E00073155,0,34,45,2,57,0,6,4,148
E00073156,0,32,36,5,26,0,3,19,121
E00073157,0,38,59,4,61,0,0,0,162
E00073158,1,45,42,2,33,0,22,6,151
E00073159,0,42,48,2,34,0,0,1,127
E00073160,0,47,60,7,46,0,7,9,176
E00073161,4,44,48,6,33,0,11,13,159
E00073162,0,31,36,2,96,1,0,2,168
E00073163,0,53,43,1,24,0,0,0,121
E00073164,0,50,37,6,25,2,2,4,126
E00073165,0,22,28,1,71,0,10,0,132
E00073166,0,32,43,4,24,0,5,2,110
E00073167,0,26,52,9,65,0,34,1,187
E00073168,1,25,34,8,55,2,17,15,157
E00073169,0,46,52,5,70,0,14,6,193
E00073170,0,21,36,10,128,2,14,3,214
E00073171,1,17,43,11,75,1,27,31,206
E00073172,0,25,36,4,21,3,43,19,151
E00073173,0,40,37,6,21,1,14,18,137
E00073174,0,43,45,2,22,0,28,4,144
E00073176,2,15,21,3,80,0,25,30,176
E00073177,0,7,13,1,57,0,66,14,158
E00073178,0,27,29,8,38,0,30,11,143
E00073179,0,33,37,1,34,0,21,11,137
E00073181,2,13,24,2,20,28,39,77,205
E00073182,0,14,21,3,92,0,51,9,190
E00073183,0,48,43,0,13,2,0,26,132
E00073184,1,25,42,3,10,1,6,33,121
E00073185,0,28,44,2,16,0,10,43,143
E00073186,0,30,36,2,13,0,1,29,111
E00073187,0,33,45,6,16,0,2,44,146
E00073188,1,24,39,2,8,1,0,37,112
E00073189,0,36,50,3,6,0,0,24,119
E00073190,0,24,33,3,15,0,7,38,120
E00073191,1,21,30,4,14,1,3,52,126
E00073192,0,28,50,1,16,0,2,25,122
E00073193,0,76,49,1,10,0,3,0,139
E00073194,0,22,29,0,10,0,15,38,114
E00073195,0,38,52,1,12,1,0,29,133
E00073196,4,24,21,2,10,0,16,43,120
E00073197,0,61,60,4,32,0,1,18,176
E00073198,0,13,10,3,11,0,24,62,123
E00073199,0,30,40,0,7,0,8,17,102
E00073200,0,26,34,1,9,2,1,57,130
E00073201,0,47,35,2,28,0,0,6,118
E00073202,0,42,38,7,64,3,5,4,163
E00073203,0,53,56,6,25,2,0,1,143
E00073204,0,36,51,4,8,0,1,15,115
E00073205,0,51,57,4,39,0,7,8,166
E00073206,0,55,68,4,22,3,1,21,174
E00073207,0,54,50,3,20,0,4,7,138
E00073208,0,50,23,3,9,1,2,29,117
E00073209,2,37,21,3,11,0,24,38,136
E00073210,0,61,64,3,13,1,0,5,147
E00073211,0,35,80,1,54,0,1,23,194
E00073212,0,12,34,7,81,0,1,34,169
E00073213,0,28,36,2,72,0,12,4,154
E00073214,0,46,53,1,33,0,0,16,149
E00073215,0,0,6,2,9,1,2,90,110
E00073216,0,10,21,0,10,0,0,91,132
E00073217,1,48,38,2,47,0,2,2,140
E00073218,2,39,56,0,39,0,2,7,145
E00073219,1,22,11,1,7,0,3,95,140
E00073220,1,25,49,4,15,0,1,51,146
E00073221,0,52,48,2,10,0,0,19,131
E00073222,1,37,53,0,6,0,19,33,149
E00073223,1,44,61,0,14,0,1,9,130
E00073224,0,44,66,4,27,0,6,1,148
E00073225,0,31,69,5,79,1,10,7,202
E00073226,0,14,22,2,20,0,0,75,133
E00073227,0,16,38,2,58,0,3,21,138
E00073228,0,33,50,7,64,0,1,3,158
E00073229,0,51,45,0,15,0,1,3,115
E00073230,0,29,61,4,46,3,1,3,147
E00073231,0,38,62,4,49,1,0,5,159
E00073232,0,46,56,3,35,0,0,1,141
E00073233,0,56,52,0,5,0,0,3,116
E00073234,0,51,45,0,23,0,2,1,122
E00073236,0,48,45,2,26,0,0,2,123
E00073237,0,33,73,3,35,0,0,1,145
E00073238,0,30,62,5,28,0,1,4,130
E00073239,0,33,85,7,82,0,7,5,219
E00073240,0,53,60,5,29,1,3,8,159
E00073241,0,31,53,2,34,1,2,6,129
E00073242,0,41,37,4,20,0,8,2,112
E00073243,0,61,61,2,5,1,1,0,131
E00073245,0,55,55,6,15,0,1,9,141
E00073246,0,46,62,0,17,0,0,9,134
E00073247,0,46,59,2,11,0,0,3,121
E00073248,0,36,63,4,33,0,0,0,136
E00073249,0,22,9,2,10,0,1,91,135
E00073250,4,50,73,7,95,1,1,3,234
E00073251,0,46,52,2,48,0,9,0,157
E00073252,1,28,50,3,27,4,5,25,143
E00073253,0,44,99,3,11,0,4,55,216
E00073254,0,25,59,6,39,2,1,11,143
E00073255,0,31,74,1,22,4,32,32,196
E00073256,0,42,46,2,37,0,24,11,162
E00073257,0,57,58,3,21,1,1,0,141
E00073258,0,44,72,4,25,2,0,9,156
E00073259,0,50,40,2,5,0,0,15,112
E00073260,0,55,52,3,14,0,0,1,125
E00073261,1,51,44,1,17,0,0,33,147
E00073262,1,19,21,2,5,0,0,64,112
E00073263,0,35,57,4,55,0,0,0,151
E00073264,0,40,53,3,28,0,4,3,131
E00073266,0,37,50,2,41,0,2,2,134
E00073267,0,50,38,4,26,0,0,2,120
E00073268,0,38,70,1,63,0,1,1,174
E00073269,0,39,50,8,66,0,0,0,163
E00073270,0,38,57,4,38,0,2,0,139
E00073271,0,56,56,4,63,2,5,3,189
E00073272,0,46,43,4,30,5,1,0,129
E00073273,0,30,38,4,32,0,12,4,120
E00073274,0,49,48,0,16,0,0,1,114
E00073276,0,15,18,5,85,2,2,1,128
E00073277,0,45,44,1,35,2,1,0,128
E00073278,0,53,59,3,16,0,0,0,131
E00073280,0,44,61,1,11,0,1,0,118
E00073281,0,38,61,1,39,0,0,2,141
E00073282,0,39,63,3,22,0,1,0,128
E00073283,0,46,54,1,15,0,0,1,117
E00073284,0,20,12,4,19,9,50,4,118
E00073285,0,49,45,1,36,0,6,4,141
E00073286,0,52,53,5,30,0,7,3,150
E00073287,0,41,60,4,15,0,0,2,122
E00073288,0,56,44,3,22,1,0,1,127
E00073289,0,53,50,2,22,0,1,0,128
E00073290,0,48,51,1,16,1,0,1,118
E00073291,0,52,41,2,32,0,0,1,128
E00073292,0,37,91,6,64,0,2,0,200
E00073293,0,57,57,3,31,0,1,1,150
E00073294,0,28,66,3,50,0,0,1,148
E00073295,0,58,53,1,16,0,1,2,131
E00073296,0,46,46,1,20,0,0,2,115
E00073297,0,47,45,1,45,1,0,2,141
E00073298,0,18,23,11,133,1,0,0,186
E00073299,0,37,70,2,35,0,1,1,146
E00073300,0,35,45,0,25,0,0,0,105
E00073301,0,54,58,3,18,7,0,4,144
E00073302,0,19,35,3,16,0,9,66,148
E00073303,1,37,63,3,17,0,3,33,157
E00073304,0,28,28,0,10,0,1,53,120
E00073305,0,41,46,5,17,0,0,24,133
E00073306,1,61,38,2,6,0,1,1,110
E00073307,0,53,40,4,14,1,1,11,124
E00073308,0,32,29,4,10,0,11,40,126
E00073309,0,33,28,3,22,0,26,18,130
E00073310,0,31,24,2,8,4,5,74,148
E00073311,0,35,22,0,8,2,3,52,122
E00073312,0,27,26,2,13,0,10,64,142
E00073313,1,31,42,4,21,2,6,38,145
E00073314,2,1,10,3,5,1,21,78,121
E00073315,2,12,12,3,10,0,28,29,96
E00073316,0,18,19,2,9,1,9,60,118
E00073317,0,26,32,2,17,0,1,39,117
E00073318,0,18,22,1,4,0,1,82,128
E00073319,0,39,82,3,55,0,0,13,192
E00073320,0,51,67,6,34,0,0,2,160
E00073321,1,47,41,1,30,0,1,25,146
E00073322,1,77,45,2,8,0,0,1,134
E00073323,0,41,45,3,18,0,2,7,116
E00073324,0,48,67,3,18,1,0,6,143
E00073325,0,38,59,6,31,0,9,19,162
E00073326,5,35,26,2,10,0,15,49,142
E00073327,0,43,52,2,12,0,1,26,136
E00073328,0,51,56,3,15,0,1,10,136
E00073329,1,50,27,4,20,2,10,18,132
E00073330,1,47,54,1,18,0,2,24,147
E00073331,0,71,86,2,8,0,0,2,169
E00073332,0,60,51,4,3,0,0,1,119
E00073333,0,72,47,1,12,0,1,2,135
E00073334,0,36,47,4,10,0,7,21,125
E00073335,0,30,42,2,18,0,51,36,179
E00073336,0,54,38,3,11,0,2,8,116
E00073337,1,36,45,1,17,1,4,25,130
E00073338,0,51,47,1,12,0,1,4,116
E00073339,0,23,40,5,56,1,11,1,137
E00073340,1,22,55,2,45,2,1,12,140
E00073341,0,31,59,1,43,1,0,1,136
E00073342,0,60,57,5,26,0,0,22,170
E00073343,0,72,57,0,24,1,2,1,157
E00073344,0,28,51,3,37,0,2,1,122
E00073345,0,22,57,5,10,3,4,5,106
E00073346,0,51,60,3,15,0,1,5,135
E00073347,0,23,26,2,50,1,3,3,108
E00073348,0,28,65,1,40,1,1,2,138
E00073349,0,21,39,5,19,0,1,37,122
E00073350,0,42,55,3,42,0,21,5,168
E00073351,1,18,49,1,10,0,0,45,124
E00073352,0,10,27,1,15,2,1,69,125
E00073353,0,40,93,1,19,1,0,0,154
E00073354,0,30,39,0,9,0,2,46,126
E00073355,0,31,49,3,28,1,0,26,138
E00073356,0,54,53,6,25,3,1,8,150
E00073357,0,45,47,3,17,0,12,3,127
E00073358,0,49,46,4,12,0,0,13,124
E00073359,0,44,61,2,13,0,1,6,127
E00073360,0,46,49,3,15,1,0,4,118
E00073361,0,31,48,6,15,1,11,12,124
E00073362,0,39,86,4,39,0,1,25,194
E00073363,0,50,54,3,14,1,0,10,132
E00073364,0,27,22,2,11,0,0,67,129
E00073365,0,39,55,3,13,0,0,14,124
E00073366,0,67,66,5,35,0,0,0,173
E00073367,0,64,45,4,17,0,1,1,132
E00073368,0,27,48,2,17,0,2,18,114
E00073369,3,39,28,3,14,0,1,37,125
E00073370,0,30,14,2,9,0,1,74,130
E00073371,1,25,16,0,8,1,1,56,108
E00073372,2,5,3,1,7,1,2,98,119
E00073373,0,34,50,1,33,0,0,0,118
E00073374,0,37,77,1,21,0,0,1,137
E00073375,0,54,53,4,21,0,0,2,134
E00073376,0,47,47,0,10,2,0,9,115
E00073377,0,23,61,3,30,0,0,2,119
E00073378,0,30,68,2,22,1,0,0,123
E00073379,0,82,44,3,13,1,0,1,144
E00073380,1,57,58,2,22,0,0,8,148
E00073381,0,46,64,3,27,0,20,0,160
E00073382,0,57,60,4,12,0,0,6,139
E00073383,2,23,12,1,10,0,0,108,156
E00073384,0,84,82,0,11,1,0,1,179
E00073385,0,41,49,2,9,0,1,26,128
E00073386,1,42,74,3,18,0,4,41,183
E00073387,0,21,38,4,8,0,1,53,125
E00073388,0,53,49,1,11,0,1,4,119
E00073389,0,25,47,8,51,0,16,4,151
E00073390,0,39,55,6,35,3,12,1,151
E00073391,0,33,52,1,25,0,14,5,130
E00073392,0,43,55,3,33,0,2,16,152
E00073393,0,31,48,0,17,1,28,1,126
E00073394,0,43,70,3,44,11,27,3,201
E00073395,0,21,16,1,5,4,77,5,129
E00073397,0,33,47,2,31,0,0,0,113
E00073398,0,31,61,3,20,1,0,3,119
E00073399,0,25,45,1,14,0,38,3,126
E00073400,0,35,60,2,27,2,1,1,128
E00073401,0,42,58,2,28,0,0,4,134
E00073402,0,29,37,2,49,0,2,2,121
E00073403,0,36,48,1,37,0,0,7,129
E00073404,0,30,73,0,30,0,0,1,134
E00073405,0,42,46,3,45,1,6,0,143
E00073406,0,37,53,0,32,0,0,0,122
E00073407,1,43,42,7,46,7,10,1,157
E00073408,0,58,56,1,15,0,0,0,130
E00073409,0,38,47,1,25,0,0,1,112
E00073410,0,48,57,2,21,0,0,2,130
E00073411,0,42,60,2,20,0,1,1,126
E00073412,0,44,53,4,30,13,11,1,156
E00073413,0,56,41,3,13,0,1,3,117
E00073414,0,2,8,1,64,0,25,16,116
E00073415,0,8,12,3,73,0,3,2,101
E00073416,0,27,22,5,73,0,3,2,132
E00073419,0,22,22,4,104,0,8,0,160
E00073420,0,8,8,2,56,0,12,2,88
E00073421,0,8,6,3,86,1,0,2,106
E00073422,2,4,0,4,19,0,20,70,119
E00073423,0,15,11,1,44,1,46,1,119
E00073424,5,0,1,6,27,0,10,76,125
E00073425,0,14,17,2,92,1,3,0,129
E00073426,0,19,15,6,84,0,0,2,126
E00073431,0,26,31,5,108,0,13,3,186
E00073432,0,3,9,4,19,0,35,18,88
E00073433,0,9,13,5,147,3,6,0,183
E00073437,3,22,21,3,60,0,4,23,136
E00073439,0,20,46,3,78,0,0,0,147
E00073440,1,30,19,2,51,1,17,9,130
E00073441,1,4,6,1,25,3,2,90,132
E00073442,0,70,36,6,48,1,3,1,165
E00073443,0,41,27,0,39,0,4,6,117
E00073444,0,14,30,1,51,0,3,16,115
E00073445,0,27,19,0,58,0,6,2,112
E00073446,0,8,21,15,108,0,9,2,163
E00073447,4,24,18,0,30,0,1,48,125
E00073448,0,38,32,2,35,0,7,2,116
E00073449,0,18,24,6,62,1,0,1,112
E00073450,0,25,27,5,72,0,0,1,130
E00073451,0,39,31,3,66,0,2,6,147
E00073452,0,39,19,3,81,4,4,1,151
E00073453,0,40,23,3,81,0,0,1,148
E00073454,0,41,31,5,80,1,0,0,158
E00073455,0,46,21,2,66,1,0,4,140
E00073456,0,47,24,2,58,0,1,0,132
E00073457,0,42,22,5,41,0,3,6,119
E00073458,0,36,26,2,62,0,1,1,128
E00073461,0,26,33,1,32,0,17,3,112
E00073462,0,34,46,1,53,2,1,1,138
E00073463,0,17,11,1,88,0,1,10,128
E00073464,0,51,42,4,31,0,6,1,135
E00073465,0,45,42,6,54,1,9,0,157
E00073466,0,23,18,1,82,20,17,1,162
E00073467,1,38,35,5,60,0,3,0,142
E00073468,0,64,45,2,29,1,1,0,142
E00073469,0,49,33,2,31,0,3,1,119
E00073470,0,59,38,6,85,0,0,0,188
E00073471,0,8,11,2,62,0,19,3,105
E00073472,0,41,20,3,59,0,1,2,126
E00073473,0,16,5,3,16,0,44,8,92
E00073474,0,22,19,2,34,0,0,1,78
E00073476,0,30,24,2,72,0,1,3,132
E00073477,0,55,33,1,46,0,0,0,135
E00073478,0,21,28,6,64,0,4,3,126
E00073479,0,39,24,3,55,0,0,2,123
E00073480,0,64,33,2,45,0,0,1,145
E00073481,0,67,31,3,119,1,1,0,222
E00073482,0,26,22,5,119,0,0,1,173
E00073483,0,28,10,6,106,0,2,1,153
E00073484,0,34,25,2,55,0,4,4,124
E00073485,0,6,10,0,68,0,31,1,116
E00073486,0,9,22,3,113,0,7,2,156
E00073487,0,2,18,5,95,2,1,4,127
E00073488,0,8,30,3,76,0,0,0,117
E00073489,0,28,36,3,45,0,1,1,114
E00073490,0,29,26,5,48,0,20,3,131
E00073491,0,20,31,5,76,0,1,1,134
E00073492,0,33,41,0,64,0,2,2,142
E00073493,0,12,27,1,90,0,3,3,136
E00073494,0,13,13,3,85,0,16,3,133
E00073495,0,14,16,1,46,1,33,0,111
E00073496,0,31,39,4,69,1,22,1,167
E00073497,0,39,25,6,54,0,0,1,125
E00073498,0,27,33,5,44,1,1,2,113
E00073499,0,32,32,2,47,0,0,2,115
E00073500,0,27,27,5,98,0,3,1,161
E00073501,0,32,36,4,55,0,0,1,128
E00073502,0,31,34,4,69,0,1,1,140
E00073503,0,30,26,3,69,1,2,1,132
E00073504,0,22,23,1,81,1,0,0,128
E00073505,0,21,10,6,62,0,0,2,101
E00073506,0,19,28,2,83,4,0,0,136
E00073507,0,37,19,2,34,0,2,3,97
E00073508,0,22,28,2,52,0,5,0,109
E00073509,0,21,17,3,80,1,3,1,126
E00073510,0,22,19,5,74,1,1,2,124
E00073511,0,18,13,3,68,0,20,1,123
E00073512,0,33,33,3,52,1,1,1,124
E00073513,0,25,23,6,101,0,3,1,159
E00073514,0,18,23,3,90,0,5,0,139
E00073515,0,24,30,3,64,0,3,3,127
E00073516,0,21,22,6,100,0,3,1,153
E00073517,0,11,12,2,97,0,7,3,132
E00073518,0,17,22,5,64,2,4,2,116
E00073519,0,19,31,3,82,0,3,1,139
E00073520,0,18,38,4,88,1,5,13,167
E00073521,0,21,35,3,57,0,4,0,120
E00073522,0,36,28,3,50,0,0,3,120
E00073523,0,11,35,5,74,0,7,1,133
E00073524,0,30,23,4,66,0,3,2,128
E00073525,1,32,37,5,75,1,2,3,156
E00073526,0,14,17,2,85,0,1,4,123
E00073527,0,15,8,1,107,1,12,0,144
E00073528,0,14,22,4,71,2,2,3,118
E00073529,0,10,19,4,83,0,21,2,139
E00073530,0,31,35,1,44,1,13,4,129
E00073531,0,24,34,2,74,2,3,0,139
E00073532,0,59,43,4,100,2,8,1,217
E00073533,0,55,38,1,15,0,3,1,113
E00073534,1,36,26,3,48,0,5,0,119
E00073535,0,22,25,1,51,0,2,2,103
E00073536,1,20,15,1,63,1,9,2,112
E00073537,0,29,52,5,60,0,0,1,147
E00073538,0,35,37,3,42,0,0,2,119
E00073539,0,25,25,0,54,0,2,5,111
E00073540,0,24,20,2,39,1,5,9,100
E00073541,0,17,29,1,65,1,1,2,116
E00073542,0,24,14,3,83,0,0,1,125
E00073543,0,26,19,0,68,0,17,1,131
E00073544,0,28,30,2,66,0,1,0,127
E00073545,0,20,49,7,107,0,3,1,187
E00073546,0,15,26,5,83,1,0,0,130
E00073547,0,10,42,3,84,1,7,0,147
E00073548,0,11,26,5,84,0,13,3,142
E00073549,0,24,36,8,71,1,7,6,153
E00073550,0,26,33,0,59,1,0,0,119
E00073551,0,16,20,5,64,0,8,2,115
E00073552,0,35,18,0,45,0,17,3,118
E00073553,0,22,31,1,57,0,0,2,113
E00073554,0,27,29,0,43,1,2,1,103
E00073555,0,17,34,2,72,0,0,2,127
E00073556,0,12,13,1,67,0,6,2,101
E00073557,0,40,37,1,35,0,0,1,114
E00073558,0,31,29,5,64,3,6,2,140
E00073559,0,40,64,2,31,1,4,2,144
E00073560,1,21,40,4,51,3,14,23,157
E00073561,0,45,42,2,32,0,43,5,169
E00073562,1,43,52,4,42,0,9,2,153
E00073563,0,48,49,4,38,1,3,3,146
E00073564,0,56,62,4,26,1,3,1,153
E00073565,0,26,27,5,131,1,29,15,234
E00073566,0,14,33,2,22,1,8,34,114
E00073567,0,27,38,8,40,0,22,6,141
E00073568,0,34,57,6,44,0,5,10,156
E00073569,0,39,71,6,38,0,8,9,171
E00073570,0,30,44,6,46,0,13,6,145
E00073571,0,45,81,1,37,0,4,3,171
E00073572,0,36,68,4,23,0,5,3,139
E00073573,0,43,74,5,68,1,12,13,216
E00073574,0,36,42,4,36,1,16,13,148
E00073575,1,41,52,5,41,5,31,9,185
E00073576,0,56,59,3,25,0,5,4,152
E00073577,1,46,34,5,32,0,18,9,145
E00073578,0,34,55,2,31,1,5,8,136
E00073579,0,25,36,2,18,2,11,5,99
E00073580,0,33,58,5,57,0,15,3,171
E00073581,2,31,46,5,50,0,3,4,141
E00073582,0,29,66,4,32,1,2,3,137
E00073583,0,28,63,3,60,1,2,0,157
E00073584,0,24,45,2,45,0,7,18,141
E00073585,0,32,63,2,55,1,1,4,158
E00073586,1,34,50,5,32,1,4,3,130
E00073587,0,18,56,1,68,0,2,3,148
E00073588,1,1,7,1,26,0,11,69,116
E00073589,0,16,16,0,53,0,1,1,87
E00073590,0,19,61,4,111,2,20,4,221
E00073591,0,22,42,3,36,0,2,20,125
E00073592,0,26,41,1,38,1,3,3,113
E00073593,0,23,52,3,37,1,2,4,122
E00073594,0,36,55,7,46,0,1,3,148
E00073595,0,33,50,2,46,1,1,4,137
E00073596,0,40,43,3,40,1,5,8,140
E00073597,1,47,56,8,100,0,14,9,235
E00073598,1,36,44,11,87,1,0,2,182
E00073599,0,56,35,2,21,2,0,1,117
E00073600,0,34,29,2,3,0,24,29,121
E00073601,1,24,45,6,41,0,2,2,121
E00073602,0,34,56,3,42,1,1,1,138
E00073603,0,28,32,7,66,3,6,0,142
E00073604,1,44,49,5,33,0,1,0,133
E00073605,0,27,33,4,47,2,4,3,120
E00073606,0,63,65,0,10,1,0,1,140
E00073607,2,16,36,2,39,0,14,29,138
E00073608,0,29,28,3,21,0,36,8,125
E00073609,0,28,25,6,85,0,4,1,149
E00073611,1,30,47,7,54,2,12,9,162
E00073612,2,31,34,3,28,0,17,32,147
E00073613,1,18,34,0,23,2,1,58,137
E00073614,0,42,98,4,52,1,28,0,225
E00073615,0,48,65,6,25,1,0,1,146
E00073616,0,44,55,2,14,0,0,14,129
E00073617,0,61,37,3,18,0,0,0,119
E00073618,0,53,28,4,39,1,0,0,125
E00073619,0,56,47,1,29,0,0,2,135
E00073620,0,57,41,1,26,1,3,1,130
E00073621,0,43,57,8,38,1,0,0,147
E00073622,0,31,33,8,34,0,23,0,129
E00073623,0,45,63,6,16,1,0,0,131
E00073624,0,16,8,3,17,0,29,36,109
E00073625,0,48,41,3,33,0,1,2,128
E00073626,1,48,25,3,11,1,37,12,138
E00073627,4,40,73,6,54,1,20,5,203
E00073628,1,13,8,1,28,0,49,20,120
E00073629,0,61,51,6,26,0,3,0,147
E00073630,1,18,48,4,121,1,2,1,196
E00073631,0,64,44,0,11,0,0,4,123
E00073632,0,44,48,1,38,0,0,1,132
E00073633,1,32,40,1,34,6,0,5,119
E00073634,0,25,44,12,106,0,11,2,200
E00073635,0,46,38,1,44,5,7,2,143
E00073636,2,28,29,0,11,0,6,62,138
E00073637,1,25,41,2,14,0,0,49,132
E00073638,0,23,41,2,10,0,0,50,126
E00073639,0,44,53,6,27,0,13,7,150
E00073640,1,21,36,1,10,1,6,51,127
E00073641,0,20,25,2,19,0,5,61,132
E00073642,4,35,36,4,13,6,3,33,134
E00073643,0,34,49,2,5,1,17,33,141
E00073644,3,29,31,3,12,0,1,52,131
E00073645,1,9,18,1,10,0,2,70,111
E00073646,0,12,26,4,21,26,37,72,198
E00073647,0,43,52,2,47,0,2,3,149
E00073648,1,11,14,0,16,0,3,89,134
E00073649,0,20,36,2,9,0,0,53,120
E00073650,3,23,29,0,10,0,0,60,125
E00073651,3,42,69,2,21,0,2,25,164
E00073652,0,20,17,1,20,0,1,74,133
E00073653,2,11,5,3,10,1,44,38,114
E00073654,0,28,31,0,14,0,0,46,119
E00073655,0,28,39,2,11,0,1,59,140
E00073656,0,30,42,2,27,0,2,41,144
E00073657,1,30,38,1,9,0,0,34,113
E00073658,1,22,35,3,11,0,0,52,124
E00073659,1,10,41,2,15,0,27,29,125
E00073660,1,37,35,1,19,0,3,46,142
E00073662,2,22,18,1,22,0,10,69,144
E00073663,2,27,24,5,13,0,8,44,123
E00073664,1,15,12,1,6,0,1,77,113
E00073665,3,17,29,1,12,0,2,82,146
E00073666,0,61,66,1,13,0,3,0,144
E00073667,0,39,53,0,21,19,17,24,173
E00073668,1,22,27,3,21,0,2,45,121
E00073669,0,28,33,0,12,1,0,27,101
E00073670,1,18,19,2,4,0,46,34,124
E00073671,1,17,40,0,10,0,0,56,124
E00073672,0,54,52,4,34,0,0,0,144
E00073673,1,25,16,2,22,1,1,53,121
E00073674,0,45,39,3,21,3,16,27,154
E00073675,0,60,36,3,6,1,1,1,108
E00073676,0,43,51,1,34,0,2,7,138
E00073677,3,15,26,2,3,4,23,60,136
E00073678,1,7,14,0,14,1,1,79,117
E00073679,1,22,17,1,11,0,1,59,112
E00073680,2,5,9,2,8,0,9,97,132
E00073681,0,39,35,4,18,0,0,15,111
E00073682,1,47,48,3,16,0,1,16,132
E00073683,1,42,49,8,21,2,31,10,164
E00073684,0,29,20,3,63,2,1,0,118
E00073685,0,26,39,2,40,1,17,2,127
E00073688,1,17,30,6,7,0,5,56,122
E00073689,0,37,50,5,29,0,0,3,124
E00073690,0,37,46,0,33,1,0,5,122
E00073691,0,36,51,5,34,0,1,0,127
E00073692,0,39,52,10,52,1,1,0,155
E00073693,0,60,46,4,65,2,29,3,209
E00073695,0,61,41,0,16,0,1,7,126
E00073696,0,61,37,4,12,0,3,13,130
E00073697,0,32,40,3,54,6,1,1,137
E00073698,1,79,37,11,71,1,5,3,208
E00073699,0,21,29,4,48,1,5,20,128
E00073700,0,22,32,1,14,1,3,46,119
E00073701,0,48,29,0,29,1,1,3,111
E00073702,0,31,41,3,10,0,1,25,111
E00073703,3,45,25,4,13,0,0,25,115
E00073704,0,83,29,1,11,0,0,1,125
E00073705,0,73,43,4,13,0,2,2,137
E00073706,0,28,42,1,16,0,4,41,132
E00073707,1,30,34,3,22,0,2,30,122
E00073708,0,90,40,1,9,0,1,11,152
E00073709,0,12,31,0,5,4,41,21,114
E00073710,0,41,37,2,9,0,5,26,120
E00073711,0,63,65,2,33,0,0,1,164
E00073712,0,10,10,0,4,0,13,84,121
E00073713,0,22,36,3,14,5,54,43,177
E00073714,2,34,28,1,9,1,4,41,120
E00073715,1,36,38,2,14,0,5,52,148
E00073716,2,6,1,1,2,0,24,77,113
E00073717,0,25,28,2,12,0,12,48,127
E00073718,0,30,54,2,14,0,10,14,124
E00073719,0,47,51,11,40,10,30,11,200
E00073720,0,30,34,1,9,0,12,47,133
E00073721,0,26,29,0,12,3,24,29,123
E00073722,0,21,41,3,13,0,5,44,127
E00073723,1,30,38,3,13,5,17,52,159
E00073724,1,16,33,0,19,0,44,61,174
E00073725,0,36,35,4,5,1,1,28,110
E00073726,0,24,18,4,11,0,0,63,120
E00073727,0,30,26,2,11,0,3,39,111
E00073728,0,37,34,3,5,1,1,45,126
E00073729,0,40,21,3,11,0,11,46,132
E00073730,1,31,20,3,8,0,0,50,113
E00073731,0,32,22,1,9,0,36,20,120
E00073732,0,13,14,4,11,6,21,54,123
E00073733,0,28,31,3,12,0,1,39,114
E00073734,0,54,42,3,11,1,0,0,111
E00073735,0,59,50,3,15,0,0,1,128
E00073736,0,41,50,3,19,0,0,2,115
E00073737,0,49,60,5,7,0,1,4,126
E00073738,0,69,44,2,13,0,0,0,128
E00073739,0,60,60,3,7,0,0,6,136
E00073740,0,50,57,1,7,0,0,5,120
E00073741,0,73,41,0,4,0,1,1,120
E00073743,1,49,59,1,12,1,3,10,136
E00073744,2,34,41,3,17,1,3,36,137
E00073745,0,2,3,0,4,0,8,92,109
E00073746,0,29,37,3,53,0,0,1,123
E00073747,0,48,37,0,38,0,1,7,131
E00073748,1,24,70,2,29,6,29,64,225
E00073749,0,76,42,2,7,0,1,1,129
E00073750,0,16,26,0,10,0,0,74,126
E00073751,1,30,26,2,4,0,14,63,140
E00073752,2,58,83,4,16,3,30,43,239
E00073754,1,18,26,3,41,0,21,62,172
E00073755,0,8,15,2,14,1,3,92,135
E00073756,0,9,6,1,21,0,9,67,113
E00073757,0,57,41,4,15,0,7,3,127
E00073758,3,26,34,2,12,0,3,70,150
E00073759,2,23,37,5,19,0,1,55,142
E00073760,0,43,36,3,36,0,7,21,146
E00073761,0,22,47,2,25,0,2,63,161
E00073762,2,61,26,5,19,0,1,16,130
E00073763,1,43,43,2,8,0,0,26,123
E00073764,1,25,28,5,25,0,1,68,153
E00073765,0,52,32,1,15,1,1,20,122
E00073766,0,16,27,2,13,0,2,82,142
E00073767,0,29,50,6,16,8,0,39,148
E00073768,0,26,46,3,14,0,3,52,144
E00073769,0,39,28,0,11,1,18,39,136
E00073770,0,22,37,3,7,1,4,45,119
E00073771,1,39,50,2,9,2,1,25,129
E00073772,0,36,39,3,7,10,12,20,127
E00073773,0,32,43,1,8,1,2,40,127
E00073774,0,33,62,6,33,0,1,33,168
E00073775,0,16,47,3,24,0,4,71,165
E00073776,1,4,24,1,8,1,3,91,133
E00073777,0,58,26,2,9,0,1,17,113
E00073778,0,52,36,1,17,0,1,14,121
E00073779,0,67,30,0,8,0,8,1,114
E00073780,2,21,26,4,28,0,1,31,113
E00073781,0,57,57,1,18,0,0,4,137
E00073782,2,53,53,1,15,0,8,20,152
E00073783,0,71,54,3,8,0,0,3,139
E00073784,0,69,77,5,20,14,29,1,215
E00073785,3,39,47,3,9,0,0,31,132
E00073786,0,24,42,3,8,4,44,51,176
E00073787,0,46,65,4,9,4,5,4,137
E00073788,0,79,41,1,9,4,0,1,135
E00073789,0,40,59,1,23,0,0,1,124
E00073790,0,59,50,3,21,17,26,2,178
E00073791,2,19,13,4,16,0,7,73,134
E00073792,3,43,41,2,14,0,27,26,156
E00073793,0,56,67,3,6,0,0,1,133
E00073794,0,31,62,1,57,7,2,3,163
E00073795,0,34,66,0,21,1,19,2,143
E00073796,3,14,9,2,7,0,66,47,148
E00073797,0,57,30,0,19,0,6,2,114
E00073798,0,47,55,6,34,0,0,2,144
E00073799,4,27,42,3,25,2,16,45,164
E00073800,0,9,14,0,5,3,71,14,116
E00073801,0,49,47,5,24,1,8,1,135
E00073802,0,40,40,1,47,0,2,13,143
E00073803,0,41,47,2,11,1,0,22,124
E00073804,0,48,38,2,8,0,2,10,108
E00073805,1,33,41,1,12,0,4,22,114
E00073806,1,70,31,4,1,0,1,2,110
E00073807,0,80,29,0,11,0,3,6,129
E00073808,0,83,31,2,9,0,0,2,127
E00073809,0,83,40,0,5,0,0,0,128
E00073810,0,56,48,1,7,0,0,0,112
E00073811,0,50,45,2,26,0,7,1,131
E00073812,1,33,42,5,20,0,3,27,131
E00073813,0,61,46,0,18,0,0,1,126
E00073814,0,65,57,3,18,15,0,2,160
E00073815,0,52,67,4,15,0,8,2,148
E00073816,0,65,36,2,6,0,1,12,122
E00073817,0,20,41,1,28,0,19,62,171
E00073818,0,70,43,9,14,0,2,4,142
E00073819,0,89,28,3,5,0,1,4,130
E00073820,0,41,34,3,21,0,4,4,107
E00073821,0,33,16,3,18,0,28,27,125
E00073822,0,59,74,2,19,0,0,0,154
E00073823,0,72,25,3,11,0,8,3,122
E00073824,0,54,46,0,22,0,1,0,123
E00073825,0,43,66,2,12,0,0,0,123
E00073826,0,60,29,3,31,0,1,0,124
E00073827,0,39,64,2,22,0,0,2,129
E00073828,0,40,39,1,38,0,0,1,119
E00073829,0,40,44,1,23,0,0,0,108
E00073830,1,29,50,0,37,0,0,2,119
E00073831,0,33,51,0,27,1,0,2,114
E00073832,0,41,35,2,17,0,6,4,105
E00073833,0,69,55,1,12,0,1,0,138
E00073834,0,76,31,2,20,0,0,0,129
E00073835,0,77,57,2,11,0,0,0,147
E00073836,0,67,21,4,9,0,3,2,106
E00073837,0,94,41,8,21,1,3,3,171
E00073838,0,65,55,3,6,0,0,2,131
E00073839,0,55,54,1,6,1,0,1,118
E00073840,0,67,47,0,5,0,2,2,123
E00073841,0,82,42,0,2,0,0,1,127
E00073842,0,61,53,2,15,2,0,1,134
E00073843,0,68,57,0,5,1,0,1,132
E00073844,0,72,55,1,4,0,0,2,134
E00073845,0,74,45,2,4,0,1,1,127
E00073846,0,78,35,5,6,0,0,2,126
E00073847,1,30,34,1,39,3,3,30,141
E00073848,0,54,51,1,12,0,2,1,121
E00073849,0,49,46,2,21,0,4,0,122
E00073850,0,68,42,1,4,0,0,3,118
E00073851,0,62,35,2,8,1,1,2,111
E00073852,1,29,33,3,11,2,28,23,130
E00073853,0,49,58,1,16,1,0,1,126
E00073854,0,47,57,2,22,0,0,6,134
E00073855,0,36,42,3,31,0,14,7,133
E00073856,1,34,54,3,16,1,1,13,123
E00073857,0,52,52,4,47,0,12,9,176
E00073858,0,51,43,4,11,1,0,12,122
E00073859,0,35,138,4,36,6,16,4,239
E00073860,1,4,2,1,3,0,9,82,102
E00073861,0,30,49,5,62,0,9,3,158
E00073862,0,58,80,8,75,1,2,16,240
E00073864,0,59,81,5,50,23,6,1,225
E00073865,0,60,57,3,11,0,0,1,132
E00073866,0,69,51,2,24,1,2,3,152
E00073867,0,41,51,1,22,0,1,12,128
E00073868,0,44,55,1,26,0,0,3,129
E00073869,0,41,40,5,26,0,1,10,123
E00073870,1,34,52,1,17,0,1,30,136
E00073871,0,8,9,3,10,1,17,74,122
E00073872,0,54,45,3,25,1,2,10,140
E00073873,1,22,44,2,15,0,0,48,132
E00073874,1,28,41,2,15,0,2,43,132
E00073875,0,40,53,6,42,3,11,3,158
E00073876,0,27,36,2,17,0,2,44,128
E00073877,0,32,53,5,43,0,8,2,143
E00073878,1,24,21,2,16,1,27,35,127
E00073879,1,26,49,4,14,0,0,51,145
E00073880,0,25,43,6,15,0,15,46,150
E00073881,0,37,57,0,32,0,0,0,126
E00073882,0,26,56,5,18,1,0,22,128
E00073883,1,19,37,2,17,0,12,48,136
E00073884,0,36,36,4,32,0,2,10,120
E00073885,0,39,46,3,21,0,0,21,130
E00073886,0,39,45,8,28,0,0,7,127
E00073887,0,48,47,2,38,0,1,1,137
E00073888,0,27,44,1,15,0,2,36,125
E00073889,0,39,34,3,35,0,14,0,125
E00073890,0,26,38,1,20,0,17,31,133
E00073891,0,30,41,4,37,0,4,17,133
E00073892,0,46,41,2,38,2,1,0,130
E00073893,0,49,59,1,31,0,5,1,146
E00073894,0,44,52,3,41,3,2,3,148
E00073895,0,37,40,3,26,0,2,12,120
E00073896,0,18,18,0,19,5,46,39,145
E00073897,1,31,40,1,75,0,2,0,150
E00073898,1,21,42,3,26,0,1,47,141
E00073899,0,43,46,4,25,2,0,16,136
E00073900,0,44,61,2,25,0,2,12,146
E00073901,0,34,43,0,71,0,0,0,148
E00073902,0,39,37,3,33,0,2,1,115
E00073904,0,40,43,0,69,0,0,0,152
E00073905,0,44,78,1,82,11,9,5,230
E00073906,0,74,47,3,16,2,0,5,147
E00073907,0,56,62,0,13,0,1,6,138
E00073908,0,21,24,2,22,1,0,60,130
E00073909,0,9,14,1,7,0,3,92,126
E00073910,1,10,12,1,14,0,3,76,117
E00073911,0,40,55,2,18,0,1,2,118
E00073912,0,48,25,1,65,0,2,20,161
E00073913,0,47,42,1,20,2,4,22,138
E00073914,0,59,43,5,32,0,0,0,139
E00073915,0,28,19,5,90,0,1,1,144
E00073916,0,63,43,4,11,0,0,1,122
E00073917,0,49,57,3,23,0,1,2,135
E00073918,0,61,39,6,13,2,36,7,164
E00073919,0,28,36,4,40,2,27,27,164
E00073921,4,19,15,1,24,0,2,46,111
E00073922,0,49,50,3,33,0,1,0,136
E00073923,0,57,32,4,33,1,19,1,147
E00073925,0,36,40,2,61,1,3,11,154
E00073926,0,37,45,4,73,0,1,2,162
E00073927,0,59,51,1,25,0,0,2,138
E00073928,0,14,29,5,85,2,0,2,137
E00073929,0,36,47,1,12,0,2,28,126
E00073930,0,23,39,3,9,0,0,49,123
E00073931,1,41,34,1,9,0,1,27,114
E00073932,0,41,34,3,6,2,8,30,124
E00073933,0,19,14,0,2,3,1,73,112
E00073934,0,34,43,3,11,2,0,22,115
E00073935,1,33,33,1,9,0,2,44,123
E00073936,0,21,18,0,5,0,30,41,115
E00073937,1,35,34,2,7,0,3,42,124
E00073938,4,6,10,5,8,0,13,74,120
E00073939,0,39,46,3,10,0,3,27,128
E00073940,2,15,21,0,10,0,11,46,105
E00073941,0,28,43,3,12,0,2,33,121
E00073942,2,6,1,0,6,0,13,107,135
E00073943,1,32,39,0,21,1,9,36,139
E00073944,2,9,7,1,6,0,3,87,115
E00073945,1,19,33,1,13,1,8,51,127
E00073946,0,44,30,0,6,1,37,26,144
E00073947,1,29,27,3,9,0,2,39,110
E00073948,0,11,23,4,8,1,1,51,99
E00073949,2,23,12,0,12,1,3,74,127
E00073950,0,15,9,5,27,0,53,60,169
E00073951,2,17,17,1,10,0,2,75,124
E00073952,1,36,38,1,12,1,0,29,118
E00073953,0,35,39,3,11,0,1,24,113
E00073954,0,10,12,2,11,2,57,25,119
E00073955,0,86,53,0,3,0,0,1,143
E00073956,0,56,35,1,7,0,20,5,124
E00073957,2,45,31,1,15,0,2,37,133
E00073958,2,41,49,1,6,0,1,30,130
E00073959,0,46,63,8,8,0,0,11,136
E00073960,0,64,47,3,15,1,0,0,130
E00073961,1,23,29,2,4,1,2,62,124
E00073962,1,39,62,0,6,2,0,11,121
E00073963,3,64,51,3,16,1,2,11,151
E00073964,0,26,27,2,5,0,1,68,129
E00073965,0,37,40,1,14,0,1,21,114
E00073966,0,28,25,0,15,4,0,50,122
E00073967,0,43,65,0,14,1,0,2,125
E00073968,0,54,57,1,17,1,4,1,135
E00073969,0,34,48,2,54,1,1,3,143
E00073970,0,50,54,1,12,0,5,2,124
E00073971,0,53,63,5,6,0,1,1,129
E00073972,0,31,61,0,29,1,2,1,125
E00073973,0,27,41,6,47,0,20,3,144
E00073974,0,71,70,2,19,0,8,6,176
E00073975,0,50,54,3,14,0,0,1,122
E00073976,0,48,49,2,22,0,3,1,125
E00073977,0,46,78,3,43,0,0,1,171
E00073978,0,41,63,2,20,2,1,1,130
E00073979,0,50,67,2,5,0,1,1,126
E00073980,0,41,51,4,12,8,7,7,130
E00073981,0,33,48,0,10,0,1,26,118
E00073982,0,44,29,5,29,0,33,5,145
E00073983,0,58,67,0,13,0,1,0,139
E00073984,0,58,59,2,21,0,10,3,153
E00073985,0,43,35,2,13,2,14,13,122
E00073986,0,39,56,4,32,1,1,3,136
E00073987,0,43,46,6,39,0,1,8,143
E00073988,0,40,33,0,15,4,1,31,124
E00073989,0,40,52,0,14,24,3,16,149
E00073990,0,43,57,0,23,1,0,21,145
E00073991,0,65,43,5,39,0,17,0,169
E00073992,0,63,39,4,11,0,0,12,129
E00073993,0,34,42,1,15,0,1,41,134
E00073994,0,34,49,1,12,0,1,29,126
E00073995,1,34,52,2,15,0,1,22,127
E00073996,0,50,53,4,23,1,1,6,138
E00073997,1,31,21,4,10,0,33,22,122
E00073998,1,15,27,3,8,0,1,86,141
E00073999,0,22,35,1,10,0,1,53,122
E00074000,0,18,23,2,19,0,48,4,114
E00074001,1,17,35,3,52,1,19,12,140
E00074002,2,11,9,5,72,0,19,85,203
E00074003,0,28,36,3,40,2,55,27,191
E00074006,2,10,13,0,18,0,59,61,163
E00074007,0,12,10,6,121,1,1,2,153
E00074008,1,5,1,1,50,1,0,81,140
E00074009,3,7,8,4,27,1,8,112,170
E00074010,3,4,7,1,14,0,4,167,200
E00074011,3,19,17,2,33,1,14,41,130
E00074012,0,10,10,4,20,1,71,16,132
E00074013,0,31,20,6,48,2,21,19,147
E00074014,2,35,43,6,54,0,13,12,165
E00074016,1,1,9,4,11,16,24,119,185
E00074018,1,35,44,8,77,2,16,8,191
E00074019,1,6,4,1,9,2,2,143,168
E00074020,0,31,43,10,57,0,20,16,177
E00074021,2,20,20,3,15,0,2,54,116
E00074022,0,29,41,7,52,8,33,14,184
E00074023,7,15,27,5,80,0,49,48,231
E00074024,0,21,22,2,48,0,13,26,132
E00074025,0,24,17,6,88,0,23,21,179
E00074026,0,33,47,9,66,2,19,21,197
E00074027,7,9,7,2,8,1,2,93,129
E00074028,0,7,4,5,30,5,80,75,206
E00074029,2,5,6,1,13,0,6,171,204
E00074030,3,10,4,0,5,0,4,95,121
E00074032,0,5,1,0,6,0,5,147,164
E00074033,2,4,2,1,13,1,1,130,154
E00074034,0,28,28,0,10,0,2,43,111
E00074037,2,1,5,1,7,2,19,84,121
E00074038,2,4,0,0,5,0,20,109,140
E00074041,3,11,14,2,11,0,11,72,124
E00074042,0,1,2,1,1,0,12,86,103
E00074045,0,34,41,3,15,0,0,24,117
E00074046,1,33,34,3,46,1,0,34,152
E00074047,2,31,32,0,9,2,6,41,123
E00074048,0,42,58,3,22,1,1,1,128
E00074049,1,32,34,5,25,0,6,46,149
E00074050,3,22,24,1,8,0,1,53,112
E00074051,0,47,61,1,39,0,0,0,148
E00074052,0,34,58,4,20,0,1,1,118
E00074053,0,56,68,6,24,0,1,0,155
E00074054,0,28,33,3,21,0,3,35,123
E00074055,0,55,66,2,52,0,0,2,177
E00074056,0,50,50,6,26,0,0,1,133
E00074057,0,63,60,2,28,0,0,1,154
E00074058,0,51,55,1,37,1,16,3,164
E00074060,2,14,24,3,52,0,44,33,172
E00074061,0,15,20,1,29,13,57,16,151
E00074062,1,30,21,4,58,0,4,35,153
E00074063,0,22,35,4,15,2,1,22,101
E00074064,1,27,32,1,17,0,5,41,124
E00074065,1,24,31,0,18,1,27,24,126
E00074066,0,21,41,2,9,1,1,52,127
E00074067,0,26,37,2,16,0,0,35,116
E00074068,3,13,19,1,12,0,8,26,82
E00074069,1,37,31,0,10,0,3,40,122
E00074070,0,18,9,3,13,2,39,69,153
E00074071,1,4,9,0,11,2,3,70,100
E00074072,2,24,32,4,21,0,2,39,124
E00074073,1,20,36,3,29,0,2,35,126
E00074074,0,24,28,0,14,0,1,51,118
E00074075,0,27,49,2,33,0,1,5,117
E00074076,0,35,37,0,21,0,0,30,123
E00074077,1,36,40,3,25,0,8,31,144
E00074078,0,36,46,5,35,0,0,1,123
E00074079,0,46,49,0,20,0,1,1,117
E00074080,1,27,43,0,44,0,0,0,115
E00074081,0,59,57,8,99,0,16,1,240
E00074082,0,22,28,6,62,0,1,1,120
E00074083,0,28,37,1,45,2,7,2,122
E00074084,0,19,35,3,68,0,1,1,127
E00074085,1,29,30,0,22,0,28,3,113
E00074086,0,41,33,1,46,0,0,0,121
E00074087,0,50,48,3,34,6,1,3,145
E00074088,0,23,34,5,110,1,20,1,194
E00074089,0,24,38,3,86,0,0,1,152
E00074090,0,33,30,3,62,0,3,0,131
E00074091,0,27,28,2,38,1,5,1,102
E00074092,0,16,31,1,71,0,4,1,124
E00074093,0,53,64,1,5,2,21,6,152
E00074094,0,56,51,1,13,0,8,2,131
E00074095,0,41,51,0,33,0,0,0,125
E00074096,0,31,41,0,50,0,0,1,123
E00074097,0,49,58,0,17,0,0,0,124
E00074098,0,52,50,3,4,0,1,0,110
E00074099,0,40,39,2,32,1,2,1,117
E00074100,0,55,60,0,10,0,0,0,125
E00074101,0,18,35,7,55,1,10,3,129
E00074102,0,50,39,2,18,0,0,3,112
E00074103,0,36,55,7,46,0,1,0,145
E00074104,0,19,22,4,101,1,1,2,150
E00074105,0,81,37,4,54,0,11,2,189
E00074106,0,39,50,0,16,0,1,1,107
E00074107,0,66,26,1,30,0,2,6,131
E00074108,0,29,55,1,47,1,3,3,139
E00074109,0,40,66,3,44,0,0,1,154
E00074110,0,30,38,2,61,0,3,1,135
E00074111,0,45,41,1,34,0,1,0,122
E00074112,0,18,26,4,85,0,1,0,134
E00074113,0,49,57,2,15,0,0,0,123
E00074114,0,39,53,3,27,0,1,2,125
E00074115,0,34,41,5,41,0,0,33,154
E00074116,0,38,63,9,72,0,9,4,195
E00074117,0,34,59,2,29,0,0,0,124
E00074118,0,55,54,5,13,0,0,7,134
E00074119,0,25,59,6,105,0,2,3,200
E00074120,0,52,64,5,44,0,0,1,166
E00074121,0,51,63,1,17,0,3,6,141
E00074122,0,34,27,4,9,0,23,14,111
E00074123,3,24,40,5,13,0,30,42,157
E00074124,0,49,49,5,28,0,0,3,134
E00074125,0,51,68,2,11,0,0,2,134
E00074126,0,52,58,0,31,2,9,1,153
E00074127,0,47,41,5,28,0,7,6,134
E00074128,0,31,56,3,35,0,7,8,140
E00074129,0,42,44,1,11,8,26,7,139
E00074130,0,63,48,3,23,1,1,0,139
E00074131,0,44,82,0,20,1,1,1,149
E00074132,0,60,43,4,13,0,1,4,125
E00074133,0,40,42,1,13,0,14,8,118
E00074134,0,53,50,4,18,0,7,2,134
E00074135,0,51,56,3,59,0,0,2,171
E00074136,0,58,63,3,17,0,3,1,145
E00074137,0,16,40,2,87,0,1,0,146
E00074138,0,56,49,0,13,1,0,1,120
E00074139,0,39,65,4,39,2,3,3,155
E00074140,0,37,42,5,42,0,2,2,130
E00074141,0,62,52,3,15,0,1,2,135
E00074142,0,41,77,3,13,2,0,0,136
E00074143,1,43,61,2,25,0,5,11,148
E00074144,0,55,57,5,11,0,0,1,129
E00074145,0,67,56,4,8,0,1,0,136
E00074146,0,68,59,3,23,1,1,1,156
E00074147,0,31,55,5,76,0,9,3,179
E00074148,0,37,55,3,20,4,1,1,121
E00074149,0,45,68,5,42,0,13,7,180
E00074150,0,17,24,1,18,0,13,31,104
E00074151,0,38,51,3,40,1,0,14,147
E00074152,0,44,29,4,26,1,1,23,128
E00074153,0,38,50,4,28,0,25,4,149
E00074154,0,38,56,2,10,0,1,23,130
E00074155,0,16,56,4,80,0,4,21,181
E00074156,1,10,23,3,87,0,13,60,197
E00074157,0,37,42,3,17,0,0,32,131
E00074158,2,29,63,0,25,1,4,27,151
E00074159,0,18,39,4,18,2,7,43,131
E00074160,0,46,48,2,20,0,0,7,123
E00074161,2,38,68,2,29,0,15,55,209
E00074162,2,15,39,1,13,0,2,45,117
E00074163,0,32,63,2,22,1,0,8,128
E00074164,0,39,53,7,17,3,0,9,128
E00074165,0,31,43,0,25,0,1,29,129
E00074166,0,49,61,7,58,2,0,0,177
E00074167,0,27,44,1,20,0,4,28,124
E00074168,1,32,45,2,42,0,21,1,144
E00074169,0,30,72,3,27,0,2,1,135
E00074170,0,32,60,1,37,1,31,6,168
E00074171,0,45,54,4,33,0,0,12,148
E00074172,0,43,47,7,50,2,1,2,152
E00074173,0,39,63,3,41,0,2,2,150
E00074174,0,17,75,6,130,1,7,1,237
E00074175,0,30,69,12,45,0,1,19,176
E00074176,0,26,53,4,47,1,7,1,139
E00074177,0,31,60,3,20,0,0,3,117
E00074178,1,25,43,6,55,1,2,36,169
E00074179,0,42,57,3,26,0,0,2,130
E00074180,1,38,56,6,64,0,5,9,179
E00074181,0,32,47,4,83,4,5,6,181
E00074182,0,3,13,3,12,1,103,8,143
E00074183,1,30,42,1,22,0,5,10,111
E00074184,2,46,47,5,27,0,2,3,132
E00074185,0,23,68,3,36,0,0,1,131
E00074186,0,19,73,3,59,1,7,4,166
E00074187,0,37,57,4,26,0,9,1,134
E00074188,0,24,46,4,23,0,1,3,101
E00074189,0,27,46,4,48,0,0,5,130
E00074190,0,61,55,2,12,0,1,2,133
E00074191,0,24,51,5,92,0,10,2,184
E00074193,0,17,18,1,10,1,4,78,129
E00074194,1,31,21,3,8,0,2,43,109
E00074195,3,44,47,4,27,5,0,5,135
E00074197,0,28,31,2,15,0,1,37,114
E00074198,0,35,37,1,14,0,16,23,126
E00074199,0,24,42,2,24,1,0,44,137
E00074200,2,26,49,3,10,0,0,39,129
E00074201,0,22,56,1,22,6,17,40,164
E00074202,1,28,44,4,43,0,4,38,162
E00074203,0,13,15,0,4,0,8,70,110
E00074204,0,33,45,4,34,5,19,45,185
E00074205,4,38,30,1,15,0,1,42,131
E00074206,1,10,31,0,11,0,8,59,120
E00074207,0,24,43,3,19,0,1,41,131
E00074208,0,36,40,2,15,0,5,27,125
E00074209,2,22,28,4,21,0,17,56,150
E00074210,2,12,19,1,4,0,4,82,124
E00074211,1,11,17,4,18,0,16,58,125
E00074212,0,48,59,2,13,2,3,8,135
E00074213,0,72,24,4,23,8,34,57,222
E00074214,0,31,39,3,66,1,2,12,154
E00074215,1,9,22,0,11,1,7,78,129
E00074216,0,34,23,2,19,2,0,32,112
E00074217,1,31,35,1,14,0,2,44,128
E00074218,0,8,13,0,28,1,15,51,116
E00074219,1,26,29,1,40,0,0,37,134
E00074220,1,28,35,2,62,1,2,24,155
E00074221,1,22,21,3,19,1,7,48,122
E00074222,2,28,28,3,9,0,0,41,111
E00074223,0,69,46,0,11,0,0,1,127
E00074224,0,52,42,3,12,1,0,2,112
E00074225,0,61,46,6,18,0,0,0,131
E00074226,0,53,51,7,29,0,0,0,140
E00074227,1,54,30,2,12,0,1,28,128
E00074228,0,19,37,3,114,0,4,3,180
E00074229,0,5,7,3,32,1,115,6,169
E00074230,0,29,74,2,47,1,7,2,162
E00074231,0,19,39,2,55,0,10,4,129
E00074232,0,5,8,0,4,1,18,88,124
E00074233,1,6,1,0,13,0,3,110,134
E00074234,1,36,40,3,19,0,21,7,127
E00074235,3,11,12,3,42,1,3,73,148
E00074236,0,41,35,5,52,0,8,2,143
E00074237,0,37,57,3,57,0,12,5,171
E00074238,0,33,40,3,52,6,26,2,162
E00074240,0,45,53,4,42,0,2,5,151
E00074241,1,44,63,2,17,1,0,1,129
E00074243,0,38,55,5,45,0,0,0,143
E00074244,0,25,55,7,70,3,0,3,163
E00074245,0,34,50,2,27,0,0,0,113
E00074246,0,41,57,6,22,0,1,0,127
E00074247,0,34,58,5,59,2,7,4,169
E00074248,0,32,51,3,36,1,8,2,133
E00074250,0,39,57,1,24,0,4,3,128
E00074251,0,33,62,0,31,0,1,0,127
E00074252,0,27,60,3,30,1,6,3,130
E00074253,0,17,29,3,72,1,1,2,125
E00074254,0,11,27,0,34,1,0,60,133
E00074255,1,1,5,0,2,0,6,106,121
E00074256,0,46,58,5,20,0,0,0,129
E00074257,0,41,55,0,77,0,1,2,176
E00074258,0,35,88,5,90,3,11,2,234
E00074259,1,3,3,1,35,1,3,103,150
E00074260,0,55,58,2,14,0,0,0,129
E00074261,0,65,56,5,19,0,0,1,146
E00074262,0,64,52,4,9,0,1,1,131
E00074263,0,31,38,5,52,0,1,4,131
E00074264,1,27,59,5,46,4,12,12,166
E00074265,0,41,54,4,39,0,1,6,145
E00074266,0,70,42,0,8,4,1,2,127
E00074267,0,56,39,1,6,0,0,10,112
E00074268,0,31,52,1,15,0,9,33,141
E00074269,0,78,41,3,8,0,0,1,131
E00074270,0,61,62,1,2,0,0,3,129
E00074271,0,40,16,8,10,8,95,14,191
E00074272,0,26,30,1,20,0,0,47,124
E00074273,3,28,49,4,8,0,0,36,128
E00074274,0,27,37,1,14,0,0,50,129
E00074275,0,76,56,5,5,3,9,4,158
E00074276,2,29,49,0,14,0,2,49,145
E00074277,0,67,48,2,4,0,1,5,127
E00074278,0,69,42,2,6,0,0,1,120
E00074279,0,67,57,5,16,7,28,4,184
E00074280,0,40,44,3,3,0,20,8,118
E00074281,0,50,43,2,15,0,1,5,116
E00074282,0,69,60,0,5,0,0,2,136
E00074283,0,72,45,2,6,0,0,1,126
E00074284,1,20,25,1,6,0,52,10,115
E00074285,0,65,37,1,7,0,1,3,114
E00074286,0,31,31,1,18,0,5,38,124
E00074287,0,20,25,4,10,0,29,52,140
E00074288,0,42,63,4,28,1,1,11,150
E00074289,0,44,44,4,9,0,10,3,114
E00074290,3,36,36,2,13,0,2,30,122
E00074291,1,27,44,0,20,0,4,27,123
E00074292,0,71,38,2,10,0,1,0,122
E00074293,0,73,49,0,13,1,0,8,144
E00074294,2,25,22,0,9,0,4,66,128
E00074295,0,25,42,5,32,1,26,3,134
E00074296,0,64,44,4,17,0,0,4,133
E00074297,0,75,65,3,11,1,2,0,157
E00074298,1,29,36,2,17,0,2,50,137
E00074299,0,19,38,4,15,1,0,49,126
E00074300,0,70,53,2,19,0,2,6,152
E00074301,0,59,50,1,5,0,0,16,131
E00074302,0,39,46,1,8,1,6,25,126
E00074303,1,56,33,5,14,1,2,1,113
E00074304,0,58,48,2,10,0,1,0,119
E00074306,0,66,38,2,10,0,2,2,120
E00074307,0,76,46,3,8,0,0,0,133
E00074308,0,80,28,1,6,0,1,3,119
E00074309,0,66,42,3,7,0,2,0,120
E00074310,0,60,37,0,20,1,0,0,118
E00074311,0,55,29,3,23,0,4,3,117
E00074312,0,35,35,2,48,0,2,1,123
E00074314,0,38,49,3,32,0,2,0,124
E00074315,0,76,36,4,15,0,1,1,133
E00074316,0,59,45,4,29,1,0,0,138
E00074317,0,67,54,3,4,1,2,1,132
E00074318,0,78,40,0,3,0,1,9,131
E00074319,0,66,59,2,5,0,0,0,132
E00074320,0,73,44,3,17,0,0,1,138
E00074321,0,55,45,0,17,0,0,1,118
E00074322,0,72,58,2,8,0,1,2,143
E00074323,0,74,51,0,5,0,0,0,130
E00074324,0,62,42,3,16,1,2,1,127
E00074325,0,38,30,2,23,1,0,28,122
E00074326,0,54,39,0,5,1,1,5,105
E00074327,0,54,4,8,11,9,57,2,145
E00074328,0,70,46,0,10,0,0,1,127
E00074329,0,51,58,0,4,0,1,3,117
E00074330,0,47,30,0,3,1,35,4,120
E00074331,0,68,48,2,3,0,0,1,122
E00074332,0,63,47,0,16,0,0,1,127
E00074333,0,56,45,4,22,0,0,0,127
E00074334,0,66,39,3,23,0,1,5,137
E00074335,0,46,58,1,17,0,2,1,125
E00074336,0,50,37,1,18,0,23,3,132
E00074337,0,50,47,0,24,0,1,3,125
E00074338,0,62,56,3,8,0,0,1,130
E00074339,0,57,45,2,6,1,0,24,135
E00074340,0,52,69,1,10,0,2,3,137
E00074341,0,43,74,4,12,0,1,0,134
E00074342,0,86,41,1,11,1,0,0,140
E00074343,0,23,22,3,20,0,1,56,125
E00074344,0,39,29,4,14,0,24,3,113
E00074345,1,61,42,1,4,0,1,2,112
E00074346,0,29,42,4,45,1,1,0,122
E00074347,0,55,46,1,8,1,3,9,123
E00074348,1,23,12,3,14,3,2,61,119
E00074349,0,42,39,2,24,1,25,1,134
E00074350,0,55,38,6,9,1,0,18,127
E00074351,0,51,39,2,14,0,0,15,121
E00074352,0,49,56,3,8,0,0,10,126
E00074353,1,61,50,0,16,0,1,4,133
E00074354,1,51,42,3,38,1,0,1,137
E00074355,0,47,48,3,12,1,0,2,113
E00074356,0,59,50,0,8,0,0,2,119
E00074357,0,63,47,1,17,0,0,3,131
E00074358,0,62,48,0,12,0,0,3,125
E00074359,1,65,30,2,19,0,2,1,120
E00074360,0,54,60,2,5,0,1,0,122
E00074361,0,59,46,1,7,1,1,4,119
E00074362,0,64,57,2,4,0,0,0,127
E00074363,0,63,58,1,1,0,0,1,124
E00074364,2,14,21,0,7,0,20,60,124
E00074365,0,83,38,2,2,0,2,1,128
E00074366,1,50,47,3,13,0,8,15,137
E00074367,6,15,10,1,4,0,40,78,154
E00074368,0,49,58,2,10,1,12,0,132
E00074369,0,40,49,0,8,1,1,19,118
E00074371,0,16,24,3,9,1,3,57,113
E00074372,0,13,18,0,12,8,9,76,136
E00074373,0,66,55,1,17,3,1,2,145
E00074374,0,31,17,2,4,0,1,61,116
E00074375,0,24,16,3,9,0,17,81,150
E00074376,0,67,50,7,8,0,1,3,136
E00074377,0,10,20,1,16,6,20,85,158
E00074378,0,67,49,0,12,1,0,0,129
E00074379,0,71,45,0,8,1,0,2,127
E00074380,0,68,45,3,1,0,0,1,118
E00074381,0,32,52,0,18,2,0,0,104
E00074382,0,78,44,1,3,0,1,0,127
E00074383,3,37,27,3,5,0,1,41,117
E00074384,2,22,19,0,5,2,1,60,111
E00074385,0,15,34,0,5,0,21,42,117
E00074386,0,87,38,2,7,0,0,0,134
E00074387,3,28,30,1,9,0,0,50,121
E00074388,0,77,27,1,3,0,0,2,110
E00074389,1,31,34,0,8,0,0,48,122
E00074390,1,1,4,0,10,0,1,89,106
E00074391,0,8,9,2,2,1,12,84,118
E00074392,1,22,19,0,9,0,27,54,132
E00074393,0,6,9,1,7,0,22,93,138
E00074394,3,11,8,2,5,2,2,87,120
E00074395,0,15,17,2,11,5,11,67,128
E00074396,0,46,53,6,20,2,3,0,130
E00074397,0,26,27,3,11,5,6,59,137
E00074398,0,70,43,2,17,0,0,1,133
E00074399,0,33,60,3,43,1,2,2,144
E00074400,0,59,39,5,27,0,3,48,181
E00074401,0,32,79,3,38,0,1,7,160
E00074402,0,42,82,0,34,0,0,1,159
E00074403,0,32,75,5,51,0,6,1,170
E00074404,0,35,52,3,46,1,1,9,147
E00074405,0,35,42,4,64,1,1,13,160
E00074406,0,27,40,1,16,12,51,36,183
E00074407,1,31,74,2,42,9,15,33,207
E00074408,0,32,75,4,14,5,6,40,176
E00074411,1,37,73,2,78,6,10,25,232
E00074412,0,6,17,1,9,0,1,87,121
E00074413,0,24,48,2,58,1,21,6,160
E00074414,0,28,47,2,51,10,4,0,142
E00074415,0,19,59,3,48,0,16,7,152
E00074416,0,36,54,5,35,0,8,9,147
E00074417,0,22,67,4,48,0,9,4,154
E00074418,0,15,39,5,47,9,10,3,128
E00074419,0,21,48,0,46,1,16,6,138
E00074420,0,28,55,2,63,0,7,11,166
E00074421,0,24,46,2,61,1,6,2,142
E00074422,0,10,16,1,44,0,72,1,144
E00074423,0,41,72,4,30,0,4,2,153
E00074424,0,11,32,5,38,36,6,2,130
E00074425,0,36,53,1,34,0,3,3,130
E00074426,0,23,48,1,60,0,6,2,140
E00074427,0,26,33,5,81,1,11,8,165
E00074428,1,31,76,3,25,0,3,12,151
E00074429,0,57,56,3,22,0,6,1,145
E00074430,0,23,49,3,74,0,6,1,156
E00074431,0,38,76,3,42,0,21,4,184
E00074432,0,44,60,2,28,0,1,7,142
E00074433,0,41,74,2,12,0,1,1,131
E00074434,1,24,40,1,14,0,5,52,137
E00074435,0,34,67,4,30,2,5,4,146
E00074436,1,48,61,6,31,0,8,1,156
E00074437,0,28,55,3,32,0,14,6,138
E00074438,0,59,79,1,15,0,8,0,162
E00074439,0,20,16,1,13,0,0,58,108
E00165771,2,11,14,4,46,1,2,120,200
E00165772,0,12,16,2,29,1,0,2,62
E00174043,0,6,16,5,57,1,3,3,91
E00174044,0,12,16,3,80,0,22,7,140
E00174046,0,19,17,2,55,0,15,1,109
E00174053,0,7,18,2,49,9,71,2,158
E00174058,0,9,21,1,63,1,49,6,150
E00174214,0,5,2,4,59,31,34,5,140
E00174215,1,6,6,1,44,0,72,2,132
E00174218,0,19,53,5,116,1,8,1,203
E00174220,0,27,12,6,9,0,0,0,54
E00174221,0,5,17,1,71,0,35,4,133
E00174225,0,8,23,1,44,0,9,3,88
E00174226,0,12,28,1,50,3,37,1,132
E00174228,0,6,10,5,33,2,64,10,130
E00174229,2,28,39,3,23,0,47,37,179
E00174231,0,5,0,6,139,0,7,0,157
E00174232,1,19,26,5,81,1,9,10,152
E00174234,0,10,29,8,112,28,23,2,212
E00174237,0,19,11,4,72,0,30,2,138
E00174239,1,4,8,1,22,0,8,4,48
E00174243,0,19,21,5,132,1,5,1,184
E00174245,0,38,25,4,16,0,13,5,101
E00174246,0,13,23,2,16,5,24,17,100
E00174248,0,3,24,4,49,5,12,4,101
E00174249,1,0,21,1,45,5,38,2,113
E00174251,0,20,48,5,108,1,21,28,231
E00174253,2,10,19,3,57,1,6,42,140
E00174254,1,19,17,4,20,0,27,25,113
E00174256,0,16,17,7,96,21,4,3,164
E00174257,0,12,49,4,98,1,30,4,198
E00174259,0,54,36,3,27,0,10,5,135
E00174260,0,4,13,2,60,0,6,4,89
E00174262,0,12,16,6,95,0,9,2,140
E00174263,0,5,16,5,71,0,2,1,100
E00174273,0,12,5,2,107,1,20,3,150
E00174275,0,21,14,10,38,0,3,0,86
E00174276,0,9,29,2,66,0,4,9,119
E00174277,0,27,20,2,79,1,32,2,163
E00174278,0,14,70,10,145,1,2,1,243
E00174279,1,3,12,2,57,0,31,5,111
E00174280,0,32,30,3,20,0,9,13,107
E00174281,0,24,42,7,19,0,4,22,118
E00174282,0,6,33,6,140,4,21,3,213
E00174283,0,25,51,1,16,10,48,4,155
E00174284,0,20,19,3,75,15,20,3,155
E00174286,0,22,56,5,29,0,0,1,113
E00174287,0,8,12,4,74,7,4,4,113
E00174288,0,13,15,2,66,0,5,23,124
E00174289,0,17,17,5,58,0,19,9,125
E00174290,0,10,9,1,2,0,19,82,123
E00174291,0,27,56,0,54,3,3,1,144
E00174292,0,8,35,4,96,9,2,5,159
E00174293,0,12,20,11,113,1,5,2,164
E00174294,0,8,15,4,93,2,0,2,124
E00174295,0,9,19,3,83,0,0,1,115
E00174296,0,12,20,8,152,3,17,0,212
E00174298,1,1,4,0,28,0,7,5,46
E00174299,0,8,40,2,107,0,19,1,177
E00174300,0,10,39,7,60,12,4,5,137
E00174302,0,2,6,2,51,5,15,2,83
E00174303,0,11,24,4,62,1,12,0,114
E00174304,0,11,22,1,17,0,0,59,110
E00174305,0,8,7,6,54,0,10,7,92
E00174306,0,3,5,0,8,0,46,43,105
E00174307,0,13,14,3,60,0,0,3,93
E00174309,0,25,23,0,41,0,3,5,97
E00174311,0,10,36,8,40,1,1,3,99
E00174312,0,13,13,7,50,0,2,2,87
E00174313,0,19,21,2,35,10,8,2,97
E00174314,0,54,4,3,19,6,44,4,134
E00174315,0,38,62,1,40,0,14,1,156
E00174316,0,5,5,1,62,0,8,2,83
E00174317,0,3,21,1,36,1,2,4,68
E00174318,0,10,20,2,15,0,2,0,49
E00174319,0,1,1,2,16,1,3,81,105
E00174320,0,4,24,4,16,6,46,26,126
E00174321,0,0,1,0,18,0,1,21,41
E00174322,2,2,0,2,13,0,2,67,88
E00174323,0,12,13,0,8,1,16,4,54
E00174324,0,9,18,4,28,0,44,2,105
E00174325,0,15,35,6,136,0,0,2,194
E00174326,0,10,36,4,80,8,17,31,186
E00174327,0,12,54,3,50,5,21,5,150
E00174328,0,11,10,0,33,4,33,0,91
E00174329,0,5,19,1,34,5,59,6,129
E00174331,0,20,18,0,1,0,0,2,41
E00174332,0,29,49,2,20,0,2,1,103
E00174333,0,24,48,2,33,0,1,2,110
E00178043,0,7,23,1,68,1,27,4,131
E00178044,0,5,15,0,69,4,7,0,100
E00178045,0,6,12,12,66,0,1,3,100
E00178046,0,18,26,12,129,1,5,0,191
E00178047,0,26,31,4,41,0,0,8,110
E00178048,0,0,2,5,85,0,11,1,104
E00178049,0,7,14,2,99,5,15,4,146
E00178050,0,0,1,0,2,0,29,84,116
E00178051,0,2,1,3,108,0,52,22,188
E00178052,0,21,29,1,44,3,13,2,113
E00178053,0,29,106,0,43,0,0,2,180
E00178054,0,5,10,3,35,13,17,11,94
E00178055,0,3,7,1,22,26,6,5,70
E00178056,0,10,4,6,81,2,1,1,105
E00178057,0,25,90,6,36,11,11,0,179
E00178058,0,7,15,1,40,1,0,0,64
E00178059,1,8,36,8,72,0,11,44,180
E00178060,0,41,38,7,97,10,29,2,224
E00178061,0,24,50,5,77,3,31,1,191
E00178062,0,14,46,4,54,1,5,8,132
E00178063,0,31,4,2,2,0,1,1,41
E00178064,0,23,21,4,3,0,0,1,52
E00178065,0,12,37,2,39,0,6,5,101
E00178066,0,8,8,5,166,3,12,3,205
E00178067,0,20,34,7,33,0,5,7,106
E00178068,0,8,20,0,16,0,2,3,49
E00178069,0,21,131,2,49,0,9,0,212
E00178070,1,71,35,3,12,2,0,1,125
E00178071,2,12,21,3,35,0,7,24,104
E00178072,0,15,17,3,104,0,9,3,151
E00178073,0,2,3,1,89,0,18,2,115
E00178074,0,41,67,1,17,0,1,0,127
E00178075,1,23,17,2,16,0,2,4,65
E00178076,0,20,34,11,126,0,4,3,198
E00178077,0,20,18,0,8,0,1,1,48
E00178078,0,3,2,0,1,0,4,75,85
E00178079,0,90,65,10,58,0,1,3,227
E00178080,4,6,1,1,10,0,2,148,172
E00178081,0,8,6,2,28,0,40,3,87
E00178082,0,22,47,5,49,0,0,2,125
E00178083,0,4,9,6,59,20,26,1,125
E00178084,0,10,52,2,192,69,28,0,353
E00178085,0,0,6,3,35,1,2,1,48
E00178086,0,31,49,10,86,3,5,1,185
E00178087,0,8,19,3,52,0,41,27,150
E00178088,0,5,34,3,25,0,1,1,69
E00178089,3,0,9,0,16,1,3,131,163
E00178090,0,4,20,2,45,0,25,1,97
E00178091,0,12,37,2,45,1,33,17,147
E00178092,0,62,47,4,46,0,10,1,170
E00178093,0,2,4,0,69,2,13,1,91
E00178094,0,6,26,3,37,1,13,2,88
E00178095,0,9,25,2,13,1,14,4,68
E00178096,0,9,9,3,76,0,2,1,100
E00178097,0,18,23,4,30,0,2,2,79
E00178098,0,8,28,1,20,0,3,50,110
E00178099,0,37,43,1,6,0,1,0,88
E00178100,0,15,45,3,27,0,1,2,93
E00178101,0,7,32,4,80,0,0,3,126
E00178102,0,33,35,2,16,0,4,40,130
E00178103,0,22,44,5,65,1,3,2,142
E00178104,4,24,29,1,5,1,1,39,104
E00178105,0,39,8,4,24,0,1,4,80
E00178106,0,36,22,5,33,0,1,1,98
E00178107,0,8,40,0,3,10,9,5,75
E00178108,0,25,103,0,15,2,50,19,214
E00178109,1,21,13,12,63,1,0,3,114
E00178110,0,6,56,3,14,11,8,1,99
E00178111,0,4,5,1,31,0,1,1,43
E00178112,0,35,25,0,162,1,14,0,237
E00178113,0,29,29,2,8,0,15,19,102
E00178114,0,22,33,3,68,0,1,1,128
E00178115,0,0,24,4,17,32,2,4,83
E00178116,2,3,0,2,10,0,0,40,57
E00178117,0,16,96,7,96,1,18,9,243
E00178118,0,10,105,0,6,24,0,7,152
E00178119,1,40,37,3,12,1,4,25,123
