Row Labels,Apprenticeship,"Level 1 and entry level qualifications: 1 to 4 GCSEs grade A* to C, Any GCSEs at other grades, O levels or CSEs (any grades), 1 AS level, NVQ level 1, Foundation GNVQ, Basic or Essential Skills","Level 2 qualifications: 5 or more GCSEs (A* to C or 9 to 4), O levels (passes), CSEs (grade 1), School Certification, 1 A level, 2 to 3 AS levels, VCEs, Intermediate or Higher Diploma, Welsh Baccalaureate Intermediate Diploma, NVQ level 2, Intermediate GNVQ, City and Guilds Craft, BTEC First or General Diploma, RSA Diploma","Level 3 qualifications: 2 or more A levels or VCEs, 4 or more AS levels, Higher School Certificate, Progression or Advanced Diploma, Welsh Baccalaureate Advance Diploma, NVQ level 3; Advanced GNVQ, City and Guilds Advanced Craft, ONC, OND, BTEC National, RSA Advanced Diploma","Level 4 qualifications or above: degree (BA, BSc), higher degree (MA, PhD, PGCE), NVQ level 4 to 5, HNC, HND, RSA Higher Diploma, BTEC Higher level, professional qualifications (for example, teaching, nursing, accountancy)",No qualifications,"Other: vocational or work-related qualifications, other qualifications achieved in England or Wales, qualifications achieved outside England or Wales (equivalent not stated or unknown)",TotalQual
E00073143,14,7,31,50,185,23,3,313
E00073145,3,14,38,78,154,45,11,343
E00073147,25,31,54,66,155,71,11,413
E00073148,4,11,18,44,163,24,5,269
E00073150,16,30,38,61,205,50,4,404
E00073152,3,10,25,62,199,27,0,326
E00073153,0,15,33,62,281,28,1,420
E00073154,9,5,21,49,192,17,1,294
E00073155,10,7,21,35,225,9,3,310
E00073156,5,16,19,40,142,14,0,236
E00073157,7,14,21,85,220,7,4,358
E00073158,3,14,19,42,159,38,11,286
E00073159,1,5,16,36,188,9,3,258
E00073160,4,10,31,37,249,14,4,349
E00073161,8,21,24,40,160,54,2,309
E00073162,4,8,26,78,230,9,0,355
E00073163,6,5,21,49,187,9,0,277
E00073164,4,16,16,37,171,22,0,266
E00073165,1,0,17,112,177,9,0,316
E00073166,7,7,19,39,161,11,0,244
E00073167,3,8,26,64,269,14,4,388
E00073168,9,17,40,46,155,38,6,311
E00073169,8,9,30,56,274,28,8,413
E00073170,4,16,24,208,273,13,3,541
E00073171,10,22,44,84,239,34,8,441
E00073172,5,11,24,29,143,32,2,246
E00073173,6,10,11,37,180,23,1,268
E00073174,6,9,27,33,180,17,6,278
E00073176,8,19,25,63,155,42,7,319
E00073177,6,21,24,58,162,17,0,288
E00073178,6,15,18,66,188,13,5,311
E00073179,0,15,19,56,169,34,3,296
E00073181,10,43,48,68,135,57,14,375
E00073182,8,22,41,88,195,42,4,400
E00073183,27,28,49,42,54,59,10,269
E00073184,12,46,39,42,47,67,6,259
E00073185,18,39,33,46,48,87,10,281
E00073186,13,27,36,51,44,57,7,235
E00073187,25,30,40,48,57,86,15,301
E00073188,10,33,36,36,35,59,4,213
E00073189,16,33,37,43,52,53,8,242
E00073190,12,29,41,45,38,153,9,327
E00073191,10,30,33,32,61,49,5,220
E00073192,8,15,31,30,71,60,2,217
E00073193,19,22,48,60,90,45,8,292
E00073194,12,38,36,40,39,54,9,228
E00073195,14,36,44,58,50,57,12,271
E00073196,11,18,25,19,44,60,15,192
E00073197,17,22,46,40,124,51,14,314
E00073198,12,24,25,20,31,59,17,188
E00073199,12,26,36,42,42,52,6,216
E00073200,15,22,39,24,45,90,1,236
E00073201,11,29,24,30,72,41,6,213
E00073202,18,38,40,33,96,39,11,275
E00073203,19,18,29,30,104,38,10,248
E00073204,18,21,33,40,68,63,4,247
E00073205,27,29,46,56,116,42,5,321
E00073206,20,42,51,56,122,64,9,364
E00073207,17,32,37,45,77,39,9,256
E00073208,14,20,28,24,59,60,6,211
E00073209,9,32,33,34,45,61,9,223
E00073210,29,30,40,61,105,46,1,312
E00073211,21,52,74,64,89,109,9,418
E00073212,19,37,45,53,65,96,15,330
E00073213,26,32,39,45,72,77,5,296
E00073214,14,34,53,60,62,71,7,301
E00073215,8,28,31,20,31,45,12,175
E00073216,12,37,38,31,56,58,1,233
E00073217,23,33,39,56,50,55,12,268
E00073218,12,35,51,42,74,90,11,315
E00073219,11,41,29,28,33,70,2,214
E00073220,12,19,36,48,65,86,17,283
E00073221,22,31,37,42,51,60,10,253
E00073222,18,54,65,40,66,61,8,312
E00073223,13,22,38,52,81,47,15,268
E00073224,12,22,36,27,139,30,0,266
E00073225,7,12,28,53,221,37,4,362
E00073226,13,13,21,21,94,60,5,227
E00073227,7,14,22,24,140,26,1,234
E00073228,13,14,19,57,176,17,2,298
E00073229,17,36,37,45,76,34,9,254
E00073230,7,10,21,46,190,14,5,293
E00073231,13,14,31,55,221,14,5,353
E00073232,7,8,17,35,176,22,0,265
E00073233,14,22,24,35,101,30,3,229
E00073234,7,13,29,51,137,21,3,261
E00073236,11,13,16,34,123,31,3,231
E00073237,6,11,20,40,188,12,1,278
E00073238,3,5,12,29,180,17,5,251
E00073239,14,16,32,68,237,42,9,418
E00073240,12,40,33,60,128,58,5,336
E00073241,7,12,11,26,163,25,1,245
E00073242,15,25,36,35,86,35,1,233
E00073243,20,29,36,46,99,47,7,284
E00073245,16,31,50,64,80,48,6,295
E00073246,15,25,30,42,115,32,9,268
E00073247,21,31,32,57,67,46,6,260
E00073248,8,17,18,42,149,24,0,258
E00073249,13,26,20,15,36,108,10,228
E00073250,12,45,43,67,202,44,12,425
E00073251,9,21,24,50,167,55,11,337
E00073252,14,22,46,50,95,56,7,290
E00073253,18,51,50,51,131,90,10,401
E00073254,15,23,20,36,135,43,12,284
E00073255,12,35,33,41,165,63,3,352
E00073256,14,27,31,45,125,57,6,305
E00073257,23,22,42,66,87,54,12,306
E00073258,16,28,37,46,135,52,6,320
E00073259,14,27,28,37,58,45,15,224
E00073260,19,30,40,44,82,44,8,267
E00073261,13,45,37,44,56,65,8,268
E00073262,3,35,30,23,33,71,4,199
E00073263,7,6,15,83,210,12,6,339
E00073264,9,13,21,73,160,22,4,302
E00073266,5,3,19,65,177,7,0,276
E00073267,9,16,21,36,132,14,3,231
E00073268,4,14,27,73,216,10,4,348
E00073269,3,8,19,81,203,20,6,340
E00073270,4,8,24,79,196,11,1,323
E00073271,10,10,27,89,249,12,3,400
E00073272,7,13,28,53,169,19,3,292
E00073273,5,9,18,31,151,13,4,231
E00073274,13,49,61,104,213,77,11,528
E00073276,0,14,13,95,135,28,3,288
E00073277,9,8,20,51,173,3,0,264
E00073278,2,6,20,28,230,12,0,298
E00073280,0,6,21,48,188,7,1,271
E00073281,3,5,21,84,206,7,1,327
E00073282,5,0,33,70,191,4,5,308
E00073283,4,6,12,37,191,15,0,265
E00073284,8,6,15,33,73,42,7,184
E00073285,7,6,24,63,204,18,1,323
E00073286,5,13,20,32,192,8,3,273
E00073287,2,7,13,26,162,15,7,232
E00073288,5,11,21,36,182,18,0,273
E00073289,4,1,26,47,200,14,1,293
E00073290,6,7,16,23,185,4,1,242
E00073291,5,11,16,33,192,12,0,269
E00073292,7,12,28,109,269,20,4,449
E00073293,7,6,21,70,191,20,3,318
E00073294,0,11,27,101,195,25,2,361
E00073295,7,14,16,36,165,9,6,253
E00073296,0,9,24,52,160,7,1,253
E00073297,8,6,22,68,175,10,9,298
E00073298,10,7,26,98,219,21,3,384
E00073299,7,17,14,45,196,17,4,300
E00073300,0,1,13,27,160,7,1,209
E00073301,19,40,54,62,77,57,5,314
E00073302,19,34,48,35,52,57,3,248
E00073303,27,50,44,48,76,65,10,320
E00073304,15,27,53,34,33,79,14,255
E00073305,11,22,47,41,69,56,8,254
E00073306,19,22,32,39,62,43,7,224
E00073307,15,24,42,33,56,57,6,233
E00073308,9,31,40,48,36,91,7,262
E00073309,23,24,26,40,29,84,9,235
E00073310,23,29,48,32,49,111,7,299
E00073311,18,40,42,37,28,80,3,248
E00073312,11,51,53,47,30,75,6,273
E00073313,16,33,43,49,69,74,4,288
E00073314,14,26,36,15,38,43,6,178
E00073315,14,24,21,18,25,38,6,146
E00073316,19,33,34,33,28,63,8,218
E00073317,16,30,29,26,39,68,11,219
E00073318,13,47,44,37,33,98,4,276
E00073319,24,29,57,71,149,39,9,378
E00073320,17,23,46,55,117,38,6,302
E00073321,22,28,39,47,58,60,5,259
E00073322,24,31,55,49,56,45,12,272
E00073323,10,15,36,47,82,30,3,223
E00073324,10,27,51,44,106,45,11,294
E00073325,7,33,38,44,104,62,7,295
E00073326,18,27,30,35,42,98,8,258
E00073327,22,31,41,36,64,80,0,274
E00073328,20,39,39,56,82,51,8,295
E00073329,16,30,37,40,46,74,7,250
E00073330,26,25,45,45,78,68,8,295
E00073331,34,28,39,79,106,51,7,344
E00073332,22,27,22,51,66,48,11,247
E00073333,25,28,39,47,51,60,8,258
E00073334,21,24,41,35,73,48,5,247
E00073335,24,53,54,55,73,85,10,354
E00073336,24,23,43,51,53,59,0,253
E00073337,15,28,49,41,64,39,4,240
E00073338,26,23,36,26,76,40,4,231
E00073339,8,6,26,47,131,30,5,253
E00073340,11,15,32,42,86,25,4,215
E00073341,9,21,34,45,112,16,5,242
E00073342,18,36,54,62,93,64,14,341
E00073343,23,28,44,59,109,38,9,310
E00073344,12,18,26,31,98,18,8,211
E00073345,9,14,17,30,56,20,2,148
E00073346,20,22,20,56,119,37,3,277
E00073347,4,18,27,20,80,12,0,161
E00073348,9,17,19,45,103,26,7,226
E00073349,7,30,34,39,80,64,4,258
E00073350,13,31,30,45,128,39,7,293
E00073351,15,32,31,48,75,74,6,281
E00073352,14,26,29,32,44,65,4,214
E00073353,15,17,38,42,153,24,2,291
E00073354,15,40,39,38,63,65,7,267
E00073355,24,36,46,48,73,56,6,289
E00073356,15,31,28,42,137,52,8,313
E00073357,19,10,39,46,87,43,7,251
E00073358,22,29,38,37,90,40,6,262
E00073359,12,34,46,47,65,49,12,265
E00073360,14,15,31,47,69,41,0,217
E00073361,18,21,26,38,86,91,5,285
E00073362,14,40,42,44,121,67,11,339
E00073363,12,31,40,46,76,66,8,279
E00073364,19,34,33,24,48,71,10,239
E00073365,19,19,35,58,64,46,6,247
E00073366,16,34,42,57,148,35,9,341
E00073367,23,32,38,42,76,43,3,257
E00073368,14,33,33,56,58,45,3,242
E00073369,16,36,34,43,65,58,3,255
E00073370,13,17,17,34,43,75,10,209
E00073371,10,19,25,25,39,51,4,173
E00073372,11,23,31,19,24,58,15,181
E00073373,9,14,32,35,100,22,6,218
E00073374,7,15,34,43,152,20,3,274
E00073375,10,26,32,45,111,39,6,269
E00073376,17,23,32,43,55,47,8,225
E00073377,10,11,25,36,126,17,1,226
E00073378,11,20,26,36,124,20,4,241
E00073379,28,32,55,64,86,51,11,327
E00073380,20,36,52,64,80,61,9,322
E00073381,23,46,59,57,97,45,5,332
E00073382,16,33,43,64,120,42,4,322
E00073383,21,28,39,24,32,63,11,218
E00073384,16,31,53,84,138,58,6,386
E00073385,17,31,44,44,47,110,0,293
E00073386,14,45,32,62,103,61,1,318
E00073387,10,32,25,28,40,61,5,201
E00073388,14,36,38,52,69,35,5,249
E00073389,10,24,37,55,110,40,13,289
E00073390,10,28,32,52,104,39,4,269
E00073391,20,37,42,38,86,31,7,261
E00073392,15,32,33,39,115,64,10,308
E00073393,12,21,28,49,84,49,6,249
E00073394,13,33,44,67,155,44,11,367
E00073395,15,34,45,45,38,57,5,239
E00073397,10,13,24,42,112,34,7,242
E00073398,6,17,29,44,118,21,1,236
E00073399,18,20,26,37,94,52,9,256
E00073400,8,17,21,40,138,20,9,253
E00073401,8,16,20,25,135,40,0,244
E00073402,11,25,33,29,114,16,3,231
E00073403,12,23,25,54,125,26,9,274
E00073404,7,14,18,34,157,19,4,253
E00073405,17,21,27,50,148,25,7,295
E00073406,16,16,28,52,112,22,4,250
E00073407,6,21,39,52,113,23,10,264
E00073408,12,12,40,40,145,32,7,288
E00073409,10,23,35,34,101,36,1,240
E00073410,11,32,26,33,123,14,12,251
E00073411,19,14,35,41,114,30,13,266
E00073412,17,15,39,56,135,36,6,304
E00073413,11,25,39,40,84,42,6,247
E00073414,6,13,31,88,123,34,5,300
E00073415,2,5,5,73,197,6,6,294
E00073416,1,2,9,82,171,7,2,274
E00073419,3,6,10,62,191,8,3,283
E00073420,5,5,9,80,88,11,1,199
E00073421,2,4,19,234,135,7,6,407
E00073422,9,21,26,20,51,46,6,179
E00073423,8,4,7,63,137,17,3,239
E00073424,5,20,22,35,61,52,6,201
E00073425,4,4,23,201,136,9,0,377
E00073426,0,4,13,197,122,6,10,352
E00073431,4,12,23,243,194,4,5,485
E00073432,5,12,11,35,53,28,6,150
E00073433,3,12,20,269,186,19,6,515
E00073437,4,2,7,24,133,26,2,198
E00073439,2,4,9,22,203,1,2,243
E00073440,4,6,20,53,145,13,0,241
E00073441,9,23,24,41,61,29,6,193
E00073442,8,13,17,86,244,5,6,379
E00073443,0,4,21,25,177,5,2,234
E00073444,2,9,13,51,136,10,0,221
E00073445,4,6,12,66,149,3,4,244
E00073446,1,8,16,156,227,4,5,417
E00073447,9,18,17,35,108,23,4,214
E00073448,3,5,15,61,167,16,3,270
E00073449,0,4,10,20,159,4,0,197
E00073450,4,7,16,49,164,9,1,250
E00073451,4,10,12,37,181,11,1,256
E00073452,1,8,11,40,191,4,5,260
E00073453,0,8,7,97,172,9,3,296
E00073454,4,8,19,55,208,7,6,307
E00073455,2,6,17,46,196,12,0,279
E00073456,0,7,10,39,177,8,3,244
E00073457,5,3,6,31,141,14,5,205
E00073458,3,6,15,25,207,7,1,264
E00073461,5,0,16,18,149,3,1,192
E00073462,1,8,21,95,210,8,6,349
E00073463,5,7,18,39,110,13,0,192
E00073464,1,5,19,299,192,4,0,520
E00073465,6,6,20,58,214,9,0,313
E00073466,7,4,24,139,216,10,1,401
E00073467,1,10,16,18,184,7,10,246
E00073468,5,10,13,60,219,6,2,315
E00073469,6,5,16,36,141,9,0,213
E00073470,7,12,16,62,224,14,9,344
E00073471,0,5,17,34,113,14,0,183
E00073472,5,7,13,28,177,6,2,238
E00073473,5,8,119,36,79,44,21,312
E00073474,1,4,10,24,111,4,1,155
E00073476,1,1,15,58,162,3,7,247
E00073477,5,5,17,44,164,5,6,246
E00073478,3,5,1,42,166,3,0,220
E00073479,3,9,20,47,140,3,6,228
E00073480,0,7,16,27,189,17,4,260
E00073481,9,4,23,114,286,8,3,447
E00073482,8,8,16,101,221,10,4,368
E00073483,2,3,14,117,181,7,3,327
E00073484,4,13,10,15,168,4,1,215
E00073485,0,9,8,86,102,12,1,218
E00073486,5,27,24,76,178,28,6,344
E00073487,1,7,9,110,146,5,0,278
E00073488,6,0,15,103,130,5,1,260
E00073489,3,1,11,25,154,3,5,202
E00073490,4,8,12,68,144,15,5,256
E00073491,0,8,11,66,225,6,6,322
E00073492,2,0,16,43,208,7,1,277
E00073493,5,6,11,69,212,15,1,319
E00073494,0,1,19,159,154,8,5,346
E00073495,3,7,13,266,114,16,6,425
E00073496,0,4,21,236,219,10,6,496
E00073497,1,5,9,66,161,8,0,250
E00073498,6,9,13,19,160,6,1,214
E00073499,5,9,18,23,148,6,0,209
E00073500,9,3,12,184,182,11,4,405
E00073501,3,2,20,111,170,2,3,311
E00073502,3,3,17,107,210,10,2,352
E00073503,3,8,9,32,162,6,1,221
E00073504,0,6,25,110,163,6,3,313
E00073505,0,3,10,64,124,7,0,208
E00073506,2,7,10,58,182,8,2,269
E00073507,3,11,13,26,90,11,4,158
E00073508,1,0,15,65,155,1,1,238
E00073509,2,8,6,66,195,10,0,287
E00073510,2,6,6,78,170,2,3,267
E00073511,1,9,15,52,152,10,3,242
E00073512,1,0,22,88,186,2,2,301
E00073513,5,4,16,50,203,3,0,281
E00073514,4,10,11,176,140,3,3,347
E00073515,1,6,15,62,182,9,3,278
E00073516,7,6,9,126,195,5,2,350
E00073517,4,8,9,76,162,9,0,268
E00073518,4,1,14,34,158,6,6,223
E00073519,3,2,9,158,152,7,2,333
E00073520,0,6,13,56,215,4,0,294
E00073521,0,1,8,149,155,7,6,326
E00073522,2,2,20,86,162,13,0,285
E00073523,3,8,11,37,172,6,0,237
E00073524,2,9,13,81,162,4,1,272
E00073525,2,8,10,53,222,8,4,307
E00073526,2,3,12,145,141,0,1,304
E00073527,0,6,14,140,144,5,10,319
E00073528,0,14,21,92,165,14,8,314
E00073529,1,7,13,148,125,7,6,307
E00073530,4,12,18,96,166,17,0,313
E00073531,2,8,11,82,198,8,0,309
E00073532,3,9,24,217,229,9,6,497
E00073533,6,3,15,52,175,4,0,255
E00073534,6,1,17,72,151,11,1,259
E00073535,2,4,17,32,134,5,1,195
E00073536,2,5,10,22,156,8,1,204
E00073537,1,3,16,60,217,2,3,302
E00073538,3,3,9,45,187,0,0,247
E00073539,3,7,9,42,128,8,3,200
E00073540,2,4,14,35,125,4,6,190
E00073541,1,6,15,94,171,14,5,306
E00073542,4,5,13,98,142,5,4,271
E00073543,0,11,20,104,153,6,7,301
E00073544,7,7,11,72,150,6,3,256
E00073545,6,8,23,111,224,10,4,386
E00073546,1,6,16,215,154,1,1,394
E00073547,3,1,11,43,180,5,0,243
E00073548,1,9,22,195,165,10,0,402
E00073549,3,11,18,38,196,5,2,273
E00073550,6,5,14,127,151,6,1,310
E00073551,4,6,14,171,116,5,5,321
E00073552,0,12,16,48,168,16,5,265
E00073553,0,2,11,74,160,5,1,253
E00073554,0,2,10,113,130,4,2,261
E00073555,4,0,16,64,162,6,1,253
E00073556,2,2,7,120,113,3,2,249
E00073557,1,3,16,105,175,5,2,307
E00073558,4,14,9,61,202,9,5,304
E00073559,9,19,17,41,176,21,0,283
E00073560,13,22,28,37,117,55,9,281
E00073561,16,39,49,39,183,44,9,379
E00073562,10,23,24,60,178,52,3,350
E00073563,2,22,21,45,204,41,9,344
E00073564,5,11,26,26,186,25,4,283
E00073565,16,49,65,41,198,115,24,508
E00073566,10,9,23,26,84,43,7,202
E00073567,7,15,21,25,137,53,8,266
E00073568,11,18,23,44,172,36,6,310
E00073569,9,29,30,64,193,40,6,371
E00073570,4,22,18,30,192,23,7,296
E00073571,6,26,36,52,171,34,6,331
E00073572,7,24,20,45,139,36,7,278
E00073573,6,23,47,66,225,69,6,442
E00073574,7,24,35,38,129,59,10,302
E00073575,9,23,39,70,191,74,8,414
E00073576,12,30,27,56,150,48,4,327
E00073577,4,22,32,45,148,42,8,301
E00073578,7,23,33,37,166,35,9,310
E00073579,17,18,24,21,77,55,18,230
E00073580,12,24,38,49,155,40,3,321
E00073581,7,18,29,35,143,29,3,264
E00073582,8,6,27,35,184,15,4,279
E00073583,12,14,19,39,160,30,1,275
E00073584,17,15,37,39,146,42,3,299
E00073585,13,15,37,54,141,41,7,308
E00073586,8,14,24,24,136,35,0,241
E00073587,12,14,23,42,162,22,7,282
E00073588,10,19,19,19,33,61,9,170
E00073589,3,10,13,19,66,12,1,124
E00073590,19,20,31,51,192,53,8,374
E00073591,7,15,17,28,85,53,2,207
E00073592,9,12,29,38,111,33,0,232
E00073593,5,15,19,29,130,31,4,233
E00073594,8,18,25,42,134,27,7,261
E00073595,11,19,20,36,135,39,7,267
E00073596,10,28,36,45,125,35,4,283
E00073597,12,40,49,62,210,88,17,478
E00073598,11,19,34,54,135,43,7,303
E00073599,12,19,27,21,74,48,0,201
E00073600,17,27,45,150,93,44,13,389
E00073601,5,13,25,49,103,31,7,233
E00073602,11,25,45,49,104,37,4,275
E00073603,19,20,27,55,119,46,10,296
E00073604,13,19,31,44,143,64,6,320
E00073605,8,18,22,30,105,29,6,218
E00073606,18,17,35,52,126,64,12,324
E00073607,6,17,18,44,88,70,4,247
E00073608,12,13,35,42,98,44,4,248
E00073609,13,10,32,45,111,70,10,291
E00073611,19,30,32,52,131,46,15,325
E00073612,19,33,26,24,84,74,26,286
E00073613,7,30,28,43,73,40,0,221
E00073614,16,29,47,82,208,66,4,452
E00073615,15,44,46,48,115,47,11,326
E00073616,15,34,35,38,88,68,9,287
E00073617,19,10,19,39,83,46,8,224
E00073618,15,18,24,43,113,62,6,281
E00073619,14,34,36,46,135,30,7,302
E00073620,6,10,23,62,139,20,6,266
E00073621,9,20,36,36,179,30,4,314
E00073622,11,16,23,103,93,22,4,272
E00073623,9,22,24,55,141,31,4,286
E00073624,4,29,32,77,44,39,9,234
E00073625,15,13,26,106,115,18,5,298
E00073626,14,21,26,32,104,46,8,251
E00073627,9,15,33,66,200,28,8,359
E00073628,4,19,25,24,56,52,1,181
E00073629,12,17,38,49,152,28,12,308
E00073630,16,32,37,74,143,76,11,389
E00073631,15,21,33,42,152,14,0,277
E00073632,7,18,25,73,173,31,5,332
E00073633,10,24,22,32,97,35,0,220
E00073634,14,44,44,96,179,45,12,434
E00073635,8,14,39,47,154,32,5,299
E00073636,15,28,37,38,44,106,12,280
E00073637,17,37,52,26,56,91,11,290
E00073638,8,32,34,29,76,77,10,266
E00073639,15,32,55,46,80,55,11,294
E00073640,11,38,28,44,65,90,6,282
E00073641,15,41,45,31,54,80,10,276
E00073642,18,28,37,29,73,84,5,274
E00073643,12,24,41,35,62,101,12,287
E00073644,17,34,29,47,45,110,9,291
E00073645,9,32,44,28,37,81,11,242
E00073646,14,49,67,56,85,116,17,404
E00073647,27,37,43,47,72,63,9,298
E00073648,13,35,47,43,39,106,10,293
E00073649,14,35,42,35,51,79,6,262
E00073650,11,34,41,34,55,76,18,269
E00073651,18,26,46,56,96,90,8,340
E00073652,12,30,27,22,54,107,5,257
E00073653,14,20,19,18,36,66,3,176
E00073654,18,35,38,35,36,92,6,260
E00073655,17,39,48,44,54,108,8,318
E00073656,20,34,44,47,55,74,9,283
E00073657,16,31,29,26,42,85,7,236
E00073658,16,36,44,25,32,75,12,240
E00073659,15,43,42,35,48,56,9,248
E00073660,18,47,55,38,57,70,14,299
E00073662,12,26,42,31,60,97,3,271
E00073663,21,28,49,31,37,86,7,259
E00073664,10,33,26,19,18,67,7,180
E00073665,14,34,29,32,46,102,7,264
E00073666,25,24,42,45,144,37,5,322
E00073667,19,45,52,58,121,82,10,387
E00073668,12,31,45,44,43,78,0,253
E00073669,13,23,28,42,63,44,8,221
E00073670,12,27,26,31,30,70,9,205
E00073671,11,45,40,35,60,72,9,272
E00073672,12,16,29,78,152,21,5,313
E00073673,13,12,26,31,75,41,4,202
E00073674,16,18,36,40,89,62,12,273
E00073675,19,15,35,40,82,30,3,224
E00073676,15,36,44,84,119,50,6,354
E00073677,15,27,34,36,72,65,3,252
E00073678,14,19,29,37,47,57,4,207
E00073679,6,15,24,20,38,71,3,177
E00073680,7,36,29,37,53,51,9,222
E00073681,3,31,35,250,115,36,9,479
E00073682,15,34,41,41,90,60,8,289
E00073683,13,27,48,51,119,60,4,322
E00073684,16,22,38,70,102,41,8,297
E00073685,14,10,31,76,107,25,6,269
E00073688,16,35,33,33,68,48,7,240
E00073689,10,26,32,45,114,28,5,260
E00073690,12,32,34,69,102,44,6,299
E00073691,12,18,20,74,129,21,3,277
E00073692,13,31,39,81,127,55,7,353
E00073693,23,33,39,82,173,65,16,431
E00073695,13,23,28,43,105,37,7,256
E00073696,19,29,24,45,72,64,8,261
E00073697,14,24,38,52,125,30,6,289
E00073698,21,30,32,94,142,98,12,429
E00073699,13,28,31,67,105,52,2,298
E00073700,6,28,29,21,64,58,11,217
E00073701,21,17,21,30,88,38,5,220
E00073702,12,18,20,51,100,29,4,234
E00073703,8,29,24,34,59,50,5,209
E00073704,20,15,31,37,85,34,8,230
E00073705,19,27,39,40,103,26,5,259
E00073706,15,32,41,53,78,59,12,290
E00073707,16,19,24,37,88,45,7,236
E00073708,19,26,30,35,84,48,12,254
E00073709,17,42,44,40,29,57,5,234
E00073710,14,34,28,30,33,71,3,213
E00073711,34,44,34,56,94,60,8,330
E00073712,9,43,40,27,27,62,10,218
E00073713,16,38,48,39,46,120,8,315
E00073714,13,20,37,30,43,74,5,222
E00073715,11,41,40,43,51,111,10,307
E00073716,3,30,41,23,26,53,6,182
E00073717,19,27,37,37,43,51,10,224
E00073718,15,29,43,47,62,69,9,274
E00073719,28,38,58,54,60,94,15,347
E00073720,17,40,46,36,53,80,7,279
E00073721,13,26,41,22,39,68,8,217
E00073722,19,51,43,34,44,114,9,314
E00073723,15,41,57,40,46,62,10,271
E00073724,20,66,56,44,53,102,13,354
E00073725,17,23,50,42,30,53,8,223
E00073726,11,20,34,32,28,79,5,209
E00073727,11,33,34,34,33,40,6,191
E00073728,13,40,37,36,33,79,13,251
E00073729,15,25,40,45,26,64,8,223
E00073730,14,24,43,37,40,73,7,238
E00073731,17,29,45,24,35,68,9,227
E00073732,14,22,29,29,32,77,7,210
E00073733,13,40,28,25,37,59,7,209
E00073734,24,26,36,42,45,48,2,223
E00073735,17,21,35,45,77,47,7,249
E00073736,20,24,34,46,66,30,3,223
E00073737,22,23,46,48,58,55,4,256
E00073738,19,29,38,54,57,63,1,261
E00073739,18,46,50,69,63,37,12,295
E00073740,21,34,28,49,65,36,8,241
E00073741,20,30,30,46,48,52,8,234
E00073743,27,29,53,58,61,56,4,288
E00073744,12,30,48,47,56,72,11,276
E00073745,11,29,29,28,31,55,14,197
E00073746,6,23,34,44,83,18,7,215
E00073747,15,24,35,54,82,31,9,250
E00073748,22,51,61,67,124,92,13,430
E00073749,11,20,38,36,106,25,7,243
E00073750,12,32,35,30,54,43,11,217
E00073751,18,28,44,33,57,60,7,247
E00073752,18,46,55,53,167,83,10,432
E00073754,26,43,33,46,72,67,19,306
E00073755,10,27,27,27,53,50,6,200
E00073756,9,19,15,16,35,50,3,147
E00073757,5,31,44,51,80,27,3,241
E00073758,12,42,48,48,69,64,8,291
E00073759,24,36,36,38,71,68,9,282
E00073760,9,18,49,43,116,29,6,270
E00073761,17,37,40,46,101,66,7,314
E00073762,16,22,29,31,100,20,4,222
E00073763,17,23,39,34,83,65,3,264
E00073764,10,27,40,39,77,78,13,284
E00073765,15,19,27,43,73,46,9,232
E00073766,11,31,47,39,50,66,6,250
E00073767,12,29,39,51,73,87,10,301
E00073768,16,33,49,39,74,51,13,275
E00073769,20,25,43,43,42,63,10,246
E00073770,20,24,39,20,52,56,6,217
E00073771,16,24,43,42,69,45,9,248
E00073772,11,26,49,36,77,52,10,261
E00073773,14,42,35,33,56,64,4,248
E00073774,27,43,34,61,114,55,9,343
E00073775,14,37,47,55,94,59,15,321
E00073776,19,31,27,34,58,53,4,226
E00073777,16,20,31,27,60,64,5,223
E00073778,19,28,30,46,78,55,2,258
E00073779,14,18,24,32,120,20,5,233
E00073780,11,22,25,38,54,41,0,191
E00073781,35,24,43,58,61,50,10,281
E00073782,28,36,59,58,69,64,6,320
E00073783,21,35,34,73,55,59,12,289
E00073784,33,41,65,71,119,61,12,402
E00073785,23,44,41,40,42,111,9,310
E00073786,25,47,77,50,64,89,9,361
E00073787,24,48,47,70,55,39,9,292
E00073788,14,35,43,53,69,59,12,285
E00073789,15,37,55,47,61,44,1,260
E00073790,32,41,66,62,66,57,9,333
E00073791,7,27,36,24,40,74,5,213
E00073792,13,37,49,61,53,80,15,308
E00073793,22,35,40,73,70,44,10,294
E00073794,17,34,49,57,60,48,5,270
E00073795,22,33,70,64,50,42,4,285
E00073796,14,33,32,20,30,92,5,226
E00073797,18,23,25,51,55,48,4,224
E00073798,16,36,41,50,57,42,14,256
E00073799,20,32,52,50,61,61,9,285
E00073800,20,31,30,23,31,70,6,211
E00073801,14,29,38,57,61,41,7,247
E00073802,18,38,32,47,63,42,7,247
E00073803,19,35,44,32,55,59,5,249
E00073804,19,21,29,40,38,55,6,208
E00073805,14,24,36,48,43,62,6,233
E00073806,16,24,40,51,43,55,7,236
E00073807,19,20,38,38,57,81,6,259
E00073808,18,25,37,33,39,66,7,225
E00073809,29,20,44,43,59,60,8,263
E00073810,17,24,38,65,61,37,3,245
E00073811,13,31,35,54,76,46,6,261
E00073812,16,28,35,52,49,59,9,248
E00073813,23,26,28,53,67,53,5,255
E00073814,27,32,41,62,86,50,11,309
E00073815,28,39,64,50,88,59,8,336
E00073816,14,33,36,35,38,75,7,238
E00073817,25,44,45,37,51,95,9,306
E00073818,5,12,26,33,183,18,7,284
E00073819,5,10,32,19,147,18,6,237
E00073820,7,3,16,24,143,29,9,231
E00073821,7,14,21,22,98,33,4,199
E00073822,4,7,25,30,219,10,6,301
E00073823,5,11,18,30,112,30,6,212
E00073824,7,10,24,37,195,4,3,280
E00073825,4,12,29,38,184,9,0,276
E00073826,10,7,32,62,160,20,1,292
E00073827,2,2,27,31,223,5,4,294
E00073828,4,10,15,25,160,21,2,237
E00073829,3,11,13,34,136,7,1,205
E00073830,4,4,21,42,188,4,4,267
E00073831,3,4,17,32,170,8,1,235
E00073832,2,2,16,34,156,9,1,220
E00073833,13,12,23,50,168,13,0,279
E00073834,6,14,21,16,149,20,5,231
E00073835,4,13,28,28,158,14,5,250
E00073836,8,7,15,18,98,17,1,164
E00073837,5,19,28,39,136,29,6,262
E00073838,8,7,32,23,191,10,1,272
E00073839,7,4,23,27,177,18,1,257
E00073840,7,1,21,34,176,19,0,258
E00073841,5,7,22,26,172,12,6,250
E00073842,6,5,35,44,171,13,2,276
E00073843,14,8,28,40,172,21,4,287
E00073844,8,1,22,29,190,14,0,264
E00073845,6,10,19,32,177,11,4,259
E00073846,8,11,24,30,141,22,6,242
E00073847,9,13,23,33,153,34,2,267
E00073848,0,8,31,39,166,15,8,267
E00073849,4,7,27,29,212,23,2,304
E00073850,8,8,13,15,175,9,1,229
E00073851,0,9,23,26,146,21,3,228
E00073852,12,27,34,43,62,72,5,255
E00073853,12,20,26,49,119,34,4,264
E00073854,10,20,37,36,108,40,9,260
E00073855,18,25,24,37,64,37,8,213
E00073856,13,23,42,38,80,56,5,257
E00073857,16,35,36,62,123,58,1,331
E00073858,10,36,31,39,77,54,1,248
E00073859,16,33,48,87,190,66,6,446
E00073860,7,12,19,15,18,74,6,151
E00073861,20,23,30,50,125,64,4,316
E00073862,24,53,62,68,149,78,12,446
E00073864,26,44,49,86,136,69,6,416
E00073865,24,37,30,54,82,43,5,275
E00073866,12,26,38,50,113,46,8,293
E00073867,8,28,33,39,100,33,7,248
E00073868,13,15,29,59,94,24,3,237
E00073869,20,27,26,55,96,28,6,258
E00073870,10,30,40,51,92,58,6,287
E00073871,7,25,39,28,36,58,14,207
E00073872,19,33,42,41,113,50,15,313
E00073873,12,41,43,56,73,66,14,305
E00073874,18,44,42,40,60,67,11,282
E00073875,13,26,42,58,126,40,13,318
E00073876,12,35,54,56,60,71,10,298
E00073877,13,26,46,58,105,58,7,313
E00073878,11,27,40,41,42,69,4,234
E00073879,11,29,62,39,79,92,7,319
E00073880,10,50,45,51,61,71,8,296
E00073881,24,42,41,59,95,37,13,311
E00073882,12,31,30,48,84,56,5,266
E00073883,7,32,41,44,71,77,9,281
E00073884,12,28,28,42,84,44,8,246
E00073885,18,29,39,52,55,61,8,262
E00073886,14,7,35,59,109,51,5,280
E00073887,12,43,31,51,102,86,14,339
E00073888,13,29,53,48,78,61,10,292
E00073889,15,13,27,44,88,47,8,242
E00073890,12,30,43,56,57,61,6,265
E00073891,18,32,38,50,85,67,4,294
E00073892,11,13,26,75,112,31,9,277
E00073893,7,11,24,87,177,7,4,317
E00073894,4,11,31,99,180,19,4,348
E00073895,11,19,35,31,106,32,4,238
E00073896,15,26,30,40,83,65,9,268
E00073897,10,6,27,64,157,22,4,290
E00073898,18,28,55,36,104,50,5,296
E00073899,20,16,37,63,122,52,5,315
E00073900,4,19,30,35,169,29,5,291
E00073901,15,10,22,102,184,19,3,355
E00073902,7,12,20,69,136,19,9,272
E00073904,11,15,30,128,149,27,6,366
E00073905,11,15,42,91,285,43,4,491
E00073906,15,18,36,34,142,36,8,289
E00073907,11,13,25,38,164,23,2,276
E00073908,6,32,32,37,85,37,12,241
E00073909,6,18,27,42,62,59,8,222
E00073910,12,36,20,16,81,43,5,213
E00073911,5,5,36,50,125,15,8,244
E00073912,9,22,31,97,169,38,3,369
E00073913,6,27,29,47,134,33,13,289
E00073914,11,8,28,60,177,17,7,308
E00073915,7,12,28,203,188,26,3,467
E00073916,12,13,34,41,151,9,5,265
E00073917,5,26,20,26,198,42,6,323
E00073918,12,36,31,51,100,58,9,297
E00073919,14,36,31,68,101,65,7,322
E00073921,8,19,26,43,65,54,2,217
E00073922,20,20,26,48,129,30,10,283
E00073923,16,30,20,56,130,46,16,314
E00073925,9,25,27,97,154,31,0,343
E00073926,15,24,34,54,161,37,12,337
E00073927,25,21,30,37,135,42,4,294
E00073928,6,10,20,129,158,15,0,338
E00073929,17,26,25,34,93,34,8,237
E00073930,13,26,34,38,79,34,9,233
E00073931,10,26,22,52,65,47,8,230
E00073932,12,29,34,32,101,44,6,258
E00073933,11,26,24,27,40,61,5,194
E00073934,13,21,32,29,72,42,10,219
E00073935,13,42,47,47,65,49,6,269
E00073936,8,31,28,22,51,56,5,201
E00073937,10,23,48,48,56,70,10,265
E00073938,6,27,27,32,33,66,5,196
E00073939,23,33,49,58,59,58,8,288
E00073940,8,18,30,29,44,62,1,192
E00073941,8,40,47,29,68,54,8,254
E00073942,9,41,33,35,28,54,6,206
E00073943,19,41,58,42,50,68,7,285
E00073944,5,12,36,35,33,62,6,189
E00073945,14,26,30,39,64,50,6,229
E00073946,16,26,44,39,95,58,9,287
E00073947,13,40,45,40,46,65,4,253
E00073948,8,18,31,28,49,73,5,212
E00073949,14,28,34,23,31,61,4,195
E00073950,18,32,45,30,50,73,11,259
E00073951,8,28,36,39,34,70,3,218
E00073952,8,15,31,24,81,32,9,200
E00073953,13,36,38,28,45,48,2,210
E00073954,7,43,51,35,26,56,9,227
E00073955,7,17,26,38,181,15,8,292
E00073956,14,16,29,40,118,33,5,255
E00073957,15,14,18,27,98,42,10,224
E00073958,15,27,37,38,99,42,6,264
E00073959,16,15,33,48,124,26,0,262
E00073960,9,12,16,32,157,17,3,246
E00073961,18,42,35,30,74,55,8,262
E00073962,20,26,28,29,108,38,5,254
E00073963,17,30,35,36,142,43,1,304
E00073964,22,32,39,40,62,64,18,277
E00073965,26,29,45,36,58,67,5,266
E00073966,10,26,29,19,49,74,9,216
E00073967,6,12,24,30,165,18,1,256
E00073968,6,10,17,34,164,32,4,267
E00073969,6,17,20,32,143,44,7,269
E00073970,8,9,27,46,143,23,7,263
E00073971,11,16,26,25,169,24,1,272
E00073972,1,7,32,47,153,12,6,258
E00073973,10,30,37,42,131,54,11,315
E00073974,14,22,36,61,180,35,9,357
E00073975,7,14,25,30,150,16,6,248
E00073976,12,18,32,36,111,41,6,256
E00073977,9,20,38,52,182,24,7,332
E00073978,6,9,27,44,147,19,6,258
E00073979,12,19,19,29,149,23,0,251
E00073980,13,14,34,44,118,40,6,269
E00073981,13,37,36,37,58,62,6,249
E00073982,13,30,37,38,92,53,3,266
E00073983,14,27,45,51,116,39,3,295
E00073984,7,20,43,42,158,37,1,308
E00073985,12,24,38,36,53,73,15,251
E00073986,14,20,21,51,127,25,4,262
E00073987,17,25,38,37,83,81,10,291
E00073988,6,34,53,49,61,62,3,268
E00073989,15,32,41,53,80,84,9,314
E00073990,17,30,50,51,83,66,3,300
E00073991,18,36,49,69,142,39,8,361
E00073992,22,31,36,53,63,77,12,294
E00073993,11,32,34,43,79,76,8,283
E00073994,8,31,44,47,56,78,9,273
E00073995,16,34,29,31,63,89,5,267
E00073996,17,28,41,50,81,54,11,282
E00073997,7,21,22,28,51,58,9,196
E00073998,9,41,41,45,36,106,8,286
E00073999,13,31,38,43,52,89,11,277
E00074000,2,21,39,37,84,65,13,261
E00074001,7,31,37,30,118,44,4,271
E00074002,11,18,26,18,138,58,0,269
E00074003,16,41,47,50,155,64,12,385
E00074006,16,32,43,37,69,76,13,286
E00074007,9,8,9,28,164,10,3,231
E00074008,6,20,19,20,82,41,2,190
E00074009,11,34,42,41,76,86,5,295
E00074010,11,56,39,34,81,89,9,319
E00074011,13,13,26,41,76,65,6,240
E00074012,7,22,18,29,67,55,13,211
E00074013,10,23,40,45,111,55,8,292
E00074014,8,18,28,62,163,39,5,323
E00074016,14,51,27,30,76,87,6,291
E00074018,9,31,42,77,197,52,11,419
E00074019,5,46,30,21,71,95,15,283
E00074020,14,29,31,72,168,46,18,378
E00074021,8,32,38,40,61,85,12,276
E00074022,22,23,39,58,148,81,15,386
E00074023,17,61,52,69,107,124,12,442
E00074024,15,45,38,56,112,62,5,333
E00074025,8,37,35,66,117,97,12,372
E00074026,12,43,44,61,158,75,14,407
E00074027,8,27,35,41,37,70,12,230
E00074028,12,40,54,32,100,98,16,352
E00074029,15,50,45,49,71,103,13,346
E00074030,9,19,11,18,24,79,14,174
E00074032,16,44,33,29,46,72,4,244
E00074033,6,52,33,25,56,88,16,276
E00074034,11,24,35,38,81,72,0,261
E00074037,9,28,24,10,50,69,4,194
E00074038,6,26,23,25,43,79,9,211
E00074041,2,39,33,34,71,59,9,247
E00074042,8,30,13,31,33,47,9,171
E00074045,13,25,33,51,78,68,5,273
E00074046,13,38,42,94,127,78,16,408
E00074047,13,36,35,32,65,58,4,243
E00074048,12,14,25,45,126,33,7,262
E00074049,14,25,40,47,86,71,5,288
E00074050,6,15,27,23,56,44,8,179
E00074051,14,13,32,66,159,30,7,321
E00074052,8,6,27,52,133,33,0,259
E00074053,16,22,48,43,141,54,9,333
E00074054,10,34,47,49,96,75,12,323
E00074055,19,32,58,85,163,68,11,436
E00074056,7,22,45,48,142,55,6,325
E00074057,14,30,46,66,108,71,10,345
E00074058,14,15,36,63,169,39,6,342
E00074060,9,30,36,63,140,70,9,357
E00074061,11,35,36,60,107,66,5,320
E00074062,14,32,32,66,107,61,7,319
E00074063,25,27,28,44,74,48,7,253
E00074064,12,26,23,43,87,53,7,251
E00074065,13,25,26,32,83,60,8,247
E00074066,10,23,38,34,81,62,7,255
E00074067,11,21,32,29,83,52,9,237
E00074068,10,21,22,42,54,39,6,194
E00074069,14,21,25,29,76,75,8,248
E00074070,23,30,28,32,50,79,6,248
E00074071,7,16,21,22,43,35,5,149
E00074072,10,33,50,50,82,53,9,287
E00074073,8,32,23,59,98,48,3,271
E00074074,12,33,42,33,70,63,12,265
E00074075,11,11,29,56,116,22,8,253
E00074076,15,20,36,45,82,51,12,261
E00074077,11,39,34,57,75,82,8,306
E00074078,6,12,24,53,151,18,5,269
E00074079,0,4,28,26,203,9,0,270
E00074080,0,5,11,50,162,6,2,236
E00074081,11,10,24,75,300,17,4,441
E00074082,4,7,12,71,155,10,6,265
E00074083,5,7,20,57,164,14,4,271
E00074084,7,4,15,57,150,0,0,233
E00074085,2,3,18,27,145,13,1,209
E00074086,6,1,19,29,178,7,0,240
E00074087,7,1,18,44,221,10,2,303
E00074088,7,6,21,234,232,16,9,525
E00074089,1,1,11,90,200,8,0,311
E00074090,5,7,21,45,180,16,2,276
E00074091,0,6,18,45,164,8,1,242
E00074092,0,2,10,50,158,6,0,226
E00074093,7,11,38,36,190,26,9,317
E00074094,8,6,29,35,185,15,3,281
E00074095,5,6,23,51,180,16,6,287
E00074096,4,8,19,54,177,8,4,274
E00074097,7,3,24,27,185,12,7,265
E00074098,5,6,18,36,171,11,3,250
E00074099,6,6,15,35,167,6,3,238
E00074100,3,7,33,13,191,9,2,258
E00074101,11,6,25,32,169,49,6,298
E00074102,1,10,21,24,163,12,1,232
E00074103,4,7,24,50,192,11,4,292
E00074104,8,14,25,64,174,10,3,298
E00074105,7,6,18,38,254,9,5,337
E00074106,3,8,29,42,167,9,0,258
E00074107,4,14,8,27,144,10,8,215
E00074108,1,6,32,58,190,8,1,296
E00074109,6,6,24,59,241,15,4,355
E00074110,3,9,21,53,178,13,4,281
E00074111,1,8,18,30,180,8,0,245
E00074112,0,2,13,113,172,8,0,308
E00074113,3,6,21,25,169,10,1,235
E00074114,1,9,17,40,204,3,7,281
E00074115,12,29,48,55,68,97,7,316
E00074116,19,41,38,62,135,59,6,360
E00074117,7,25,24,41,114,33,6,250
E00074118,25,25,32,57,63,39,5,246
E00074119,13,28,41,67,129,51,11,340
E00074120,20,31,55,44,129,32,6,317
E00074121,17,36,41,49,102,42,4,291
E00074122,14,18,18,27,56,54,7,194
E00074123,14,21,40,47,77,78,8,285
E00074124,18,36,50,33,78,32,10,257
E00074125,16,26,45,58,66,44,13,268
E00074126,25,25,40,52,111,46,10,309
E00074127,16,19,32,38,89,45,10,249
E00074128,8,19,45,58,82,45,6,263
E00074129,28,33,41,46,67,45,5,265
E00074130,28,28,52,60,73,54,3,298
E00074131,15,25,33,53,148,18,5,297
E00074132,27,30,36,43,49,63,10,258
E00074133,22,23,28,43,85,31,3,235
E00074134,25,27,33,41,78,56,6,266
E00074135,22,28,36,56,115,47,11,315
E00074136,22,27,36,35,86,51,14,271
E00074137,8,21,22,46,118,24,0,239
E00074138,27,26,45,44,55,55,4,256
E00074139,16,19,32,57,128,20,0,272
E00074140,15,23,28,36,71,40,9,222
E00074141,28,28,42,61,72,49,4,284
E00074142,22,26,35,46,97,40,8,274
E00074143,18,36,46,58,73,62,7,300
E00074144,20,23,43,50,75,39,10,260
E00074145,26,26,38,55,66,43,4,258
E00074146,22,31,33,51,105,59,4,305
E00074147,20,32,35,73,128,40,7,335
E00074148,11,22,39,58,78,34,11,253
E00074149,20,37,48,64,110,86,6,371
E00074150,11,22,22,26,54,54,10,199
E00074151,12,38,49,45,87,53,6,290
E00074152,19,38,27,39,55,54,8,240
E00074153,20,31,30,43,84,46,0,254
E00074154,14,25,37,49,82,72,8,287
E00074155,17,22,35,46,131,44,6,301
E00074156,16,29,31,39,99,77,10,301
E00074157,11,33,31,39,82,53,9,258
E00074158,17,24,30,45,97,47,10,270
E00074159,9,42,52,44,66,72,10,295
E00074160,15,30,29,47,79,61,9,270
E00074161,15,31,46,36,170,72,10,380
E00074162,14,28,36,34,53,78,10,253
E00074163,15,19,41,38,73,64,11,261
E00074164,10,20,25,39,97,48,9,248
E00074165,19,27,42,39,67,76,15,285
E00074166,15,22,43,51,149,45,8,333
E00074167,16,26,28,34,56,58,9,227
E00074168,7,19,13,39,115,40,7,240
E00074169,8,14,15,33,173,14,1,258
E00074170,18,26,33,56,123,41,10,307
E00074171,15,12,30,45,100,45,10,257
E00074172,17,27,32,42,108,51,6,283
E00074173,15,28,29,47,132,31,3,285
E00074174,14,18,30,59,215,26,7,369
E00074175,14,21,40,53,153,53,9,343
E00074176,10,22,25,45,124,19,7,252
E00074177,16,18,35,47,64,39,3,222
E00074178,4,18,25,37,140,52,3,279
E00074179,16,33,28,48,100,73,16,314
E00074180,15,35,30,44,147,62,15,348
E00074181,14,18,23,43,174,59,11,342
E00074182,7,27,19,29,57,73,11,223
E00074183,9,17,19,38,109,44,4,240
E00074184,19,12,23,62,89,37,8,250
E00074185,5,7,21,35,150,21,2,241
E00074186,10,14,20,38,174,32,9,297
E00074187,4,12,17,24,147,23,11,238
E00074188,7,7,20,27,105,21,4,191
E00074189,8,7,32,32,130,23,0,232
E00074190,20,11,42,47,126,33,8,287
E00074191,11,22,40,54,148,78,7,360
E00074193,12,44,48,28,41,105,9,287
E00074194,9,20,25,32,55,31,3,175
E00074195,9,30,27,39,92,34,5,236
E00074197,5,29,25,38,59,62,5,223
E00074198,22,31,36,50,72,71,12,294
E00074199,12,52,56,53,77,62,3,315
E00074200,12,33,38,36,74,77,5,275
E00074201,12,59,58,64,107,60,16,376
E00074202,12,38,59,43,96,86,4,338
E00074203,13,23,34,13,35,50,7,175
E00074204,14,52,54,66,118,79,8,391
E00074205,22,35,39,37,61,66,8,268
E00074206,14,34,45,30,58,70,6,257
E00074207,18,45,42,51,67,68,11,302
E00074208,15,26,46,53,84,60,9,293
E00074209,16,35,50,58,84,90,13,346
E00074210,19,47,52,32,49,88,7,294
E00074211,24,46,34,22,59,83,8,276
E00074212,22,23,37,35,110,32,3,262
E00074213,17,22,37,38,142,100,21,377
E00074214,16,25,32,63,125,69,13,343
E00074215,6,48,49,35,61,104,0,303
E00074216,15,31,44,33,57,68,13,261
E00074217,16,36,43,49,69,60,11,284
E00074218,14,24,24,33,70,57,8,230
E00074219,16,45,51,53,102,52,8,327
E00074220,14,40,44,51,109,88,8,354
E00074221,12,31,25,35,74,74,7,258
E00074222,7,15,23,23,79,36,3,186
E00074223,18,32,29,44,67,41,7,238
E00074224,8,13,33,35,87,25,4,205
E00074225,13,29,28,38,90,48,7,253
E00074226,16,16,45,38,82,38,6,241
E00074227,13,31,34,45,66,61,16,266
E00074228,8,8,19,38,204,5,0,282
E00074229,8,28,33,43,85,47,8,252
E00074230,7,10,20,40,252,17,4,350
E00074231,8,9,17,44,171,12,4,265
E00074232,11,16,23,20,36,82,1,189
E00074233,9,27,34,20,51,51,3,195
E00074234,7,9,20,24,156,21,0,237
E00074235,9,18,23,36,90,66,4,246
E00074236,1,15,15,36,205,20,4,296
E00074237,7,18,24,43,264,24,0,380
E00074238,17,9,18,53,160,38,4,299
E00074240,9,20,30,47,204,20,6,336
E00074241,8,8,17,30,206,15,0,284
E00074243,6,8,19,31,218,12,0,294
E00074244,9,9,25,38,224,17,3,325
E00074245,4,8,11,42,173,12,0,250
E00074246,7,9,19,34,187,13,5,274
E00074247,13,14,23,54,209,24,1,338
E00074248,8,7,24,31,189,8,2,269
E00074250,7,4,14,31,179,12,6,253
E00074251,6,6,13,33,186,14,0,258
E00074252,13,6,22,34,162,10,2,249
E00074253,5,10,16,42,171,19,7,270
E00074254,3,21,15,46,103,48,8,244
E00074255,10,18,13,17,11,99,3,171
E00074256,6,15,13,29,181,13,0,257
E00074257,8,15,26,35,190,17,9,300
E00074258,10,10,24,51,289,23,5,412
E00074259,12,22,16,18,65,76,9,218
E00074260,10,23,22,43,120,40,8,266
E00074261,14,22,28,42,149,42,3,300
E00074262,20,31,32,47,102,43,6,281
E00074263,4,12,17,60,187,24,1,305
E00074264,7,12,18,43,211,84,5,380
E00074265,10,10,24,41,200,22,0,307
E00074266,14,27,43,35,57,62,5,243
E00074267,20,27,37,34,59,43,13,233
E00074268,22,29,48,49,69,46,9,272
E00074269,25,25,46,35,59,42,8,240
E00074270,26,22,36,65,43,48,15,255
E00074271,31,25,31,32,35,107,6,267
E00074272,12,26,31,36,51,57,8,221
E00074273,21,29,46,50,58,64,0,268
E00074274,8,31,32,33,45,65,4,218
E00074275,26,50,47,68,91,56,12,350
E00074276,16,46,47,50,52,70,6,287
E00074277,20,25,42,60,67,59,5,278
E00074278,26,32,37,52,51,34,10,242
E00074279,27,47,63,82,91,70,6,386
E00074280,18,28,54,40,39,42,5,226
E00074281,23,20,35,51,50,37,8,224
E00074282,30,31,59,68,52,44,9,293
E00074283,31,28,53,40,51,51,7,261
E00074284,13,14,30,23,43,55,4,182
E00074285,26,35,48,47,41,48,14,259
E00074286,14,32,32,25,47,50,3,203
E00074287,16,22,40,26,35,86,5,230
E00074288,21,37,63,67,72,76,11,347
E00074289,16,20,46,44,51,48,3,228
E00074290,7,38,25,40,32,72,4,218
E00074291,7,30,36,37,37,43,1,191
E00074292,16,26,45,62,66,40,12,267
E00074293,20,40,57,46,46,73,11,293
E00074294,12,28,18,27,38,63,10,196
E00074295,21,35,52,60,50,56,7,281
E00074296,19,30,52,54,86,42,6,289
E00074297,22,41,52,67,128,64,10,384
E00074298,12,33,28,42,42,64,4,225
E00074299,15,32,46,33,54,52,7,239
E00074300,25,28,46,62,102,54,13,330
E00074301,0,10,31,25,172,27,3,268
E00074302,13,18,36,39,139,52,12,309
E00074303,1,11,21,28,127,3,7,198
E00074304,13,9,26,24,137,8,5,222
E00074306,7,12,25,16,140,20,4,224
E00074307,7,10,30,30,188,12,4,281
E00074308,6,16,35,27,133,16,5,238
E00074309,8,10,32,31,160,15,1,257
E00074310,3,9,18,19,158,25,8,240
E00074311,11,15,18,21,95,14,2,176
E00074312,5,13,12,29,132,7,4,202
E00074314,1,8,13,32,170,11,1,236
E00074315,6,11,23,25,162,9,0,236
E00074316,4,9,11,28,181,13,6,252
E00074317,7,10,32,25,152,15,5,246
E00074318,7,10,22,35,144,27,5,250
E00074319,9,7,30,53,161,11,6,277
E00074320,11,14,24,25,182,22,4,282
E00074321,7,12,30,39,157,15,0,260
E00074322,1,15,19,37,181,16,6,275
E00074323,1,13,34,32,175,10,1,266
E00074324,1,12,21,25,169,13,4,245
E00074325,6,6,16,23,121,22,2,196
E00074326,11,12,21,23,121,23,3,214
E00074327,6,4,24,10,107,13,12,176
E00074328,14,9,26,28,135,12,3,227
E00074329,9,6,30,28,170,5,6,254
E00074330,9,14,39,25,176,45,16,324
E00074331,8,12,56,24,192,20,6,318
E00074332,8,7,29,36,165,14,6,265
E00074333,12,12,23,41,171,70,8,337
E00074334,5,14,23,30,148,12,5,237
E00074335,12,12,21,33,143,13,2,236
E00074336,9,15,13,23,143,84,19,306
E00074337,6,17,26,29,114,21,6,219
E00074338,14,13,33,39,137,20,10,266
E00074339,4,17,27,35,129,33,6,251
E00074340,10,20,24,36,149,24,3,266
E00074341,11,11,29,39,140,22,6,258
E00074342,11,16,26,41,173,34,8,309
E00074343,7,19,27,33,61,44,8,199
E00074344,6,13,25,26,96,21,4,191
E00074345,15,9,34,29,107,16,6,216
E00074346,8,21,18,34,112,11,9,213
E00074347,5,11,26,31,158,17,7,255
E00074348,11,12,14,33,57,42,10,179
E00074349,11,7,19,32,142,22,5,238
E00074350,12,8,36,22,122,28,3,231
E00074351,8,30,21,26,114,29,8,236
E00074352,9,7,19,18,162,24,1,240
E00074353,8,8,10,21,175,13,0,235
E00074354,6,9,19,33,150,25,4,246
E00074355,9,14,24,30,142,10,8,237
E00074356,5,13,23,28,159,10,1,239
E00074357,9,17,30,37,142,18,11,264
E00074358,7,10,22,34,163,15,4,255
E00074359,10,15,17,22,126,21,8,219
E00074360,3,8,29,23,182,8,3,256
E00074361,3,10,26,27,178,18,0,262
E00074362,6,11,36,30,172,17,7,279
E00074363,25,23,43,64,55,42,7,259
E00074364,8,40,43,35,44,68,5,243
E00074365,24,30,35,62,60,42,7,260
E00074366,20,40,51,44,32,78,11,276
E00074367,15,47,48,39,35,104,13,301
E00074368,22,32,46,59,52,55,9,275
E00074369,11,40,24,24,37,66,3,205
E00074371,6,28,29,24,31,69,17,204
E00074372,15,32,32,24,33,70,9,215
E00074373,16,39,54,61,58,65,11,304
E00074374,16,33,39,26,29,59,4,206
E00074375,9,48,62,34,33,104,11,301
E00074376,31,35,56,53,50,56,0,281
E00074377,18,49,47,49,36,73,9,281
E00074378,20,39,48,42,53,47,6,255
E00074379,22,26,40,48,51,56,6,249
E00074380,15,29,50,40,69,36,5,244
E00074381,14,26,33,53,44,35,0,205
E00074382,28,40,49,44,43,47,9,260
E00074383,11,31,36,27,44,64,4,217
E00074384,11,42,32,28,27,82,6,228
E00074385,18,36,44,34,31,77,7,247
E00074386,26,24,34,58,61,54,12,269
E00074387,16,22,34,24,35,68,6,205
E00074388,18,28,40,47,53,32,3,221
E00074389,11,23,45,35,36,85,5,240
E00074390,7,30,21,10,26,52,5,151
E00074391,6,21,36,19,28,76,10,196
E00074392,6,35,34,33,35,82,6,231
E00074393,9,45,45,38,32,67,7,243
E00074394,10,35,36,21,27,69,4,202
E00074395,15,39,28,36,37,76,5,236
E00074396,23,33,47,45,63,47,5,263
E00074397,12,28,43,25,48,88,7,251
E00074398,32,22,46,60,59,62,7,288
E00074399,3,15,20,27,206,18,5,294
E00074400,20,43,70,53,114,98,12,410
E00074401,8,13,26,35,237,23,1,343
E00074402,13,5,19,22,222,17,1,299
E00074403,4,7,27,37,257,11,1,344
E00074404,11,19,19,44,165,34,5,297
E00074405,14,15,30,60,146,47,7,319
E00074406,14,31,30,60,111,88,9,343
E00074407,14,30,42,53,181,65,12,397
E00074408,16,33,57,46,123,71,15,361
E00074411,13,33,41,74,229,74,15,479
E00074412,11,38,29,28,71,59,8,244
E00074413,12,22,21,45,169,21,4,294
E00074414,5,11,13,39,158,17,2,245
E00074415,5,13,14,38,166,26,4,266
E00074416,6,13,31,50,172,28,4,304
E00074417,5,16,26,42,166,22,6,283
E00074418,6,21,14,34,125,12,0,212
E00074419,4,10,13,31,171,25,0,254
E00074420,5,15,17,39,209,21,10,316
E00074421,7,17,18,31,156,25,0,254
E00074422,5,20,31,43,103,37,8,247
E00074423,5,12,19,32,191,15,1,275
E00074424,2,9,28,30,128,14,2,213
E00074425,5,9,26,22,170,10,4,246
E00074426,4,6,15,34,177,12,3,251
E00074427,5,10,30,30,166,34,4,279
E00074428,6,5,11,24,199,18,5,268
E00074429,17,22,28,39,148,25,4,283
E00074430,8,17,28,36,173,18,8,288
E00074431,10,16,30,55,219,48,4,382
E00074432,7,9,21,48,195,22,0,302
E00074433,5,12,20,27,184,14,0,262
E00074434,7,26,34,32,105,28,5,237
E00074435,4,17,29,39,152,25,2,268
E00074436,14,21,31,46,172,36,6,326
E00074437,5,19,18,41,202,23,0,308
E00074438,13,17,24,45,170,40,4,313
E00074439,8,15,15,13,72,38,5,166
E00165771,8,24,35,136,136,61,17,417
E00165772,2,6,9,29,75,3,2,126
E00174043,4,3,25,216,141,5,1,395
E00174044,10,32,36,68,109,53,5,313
E00174046,0,7,14,160,131,10,5,327
E00174053,7,23,29,46,141,36,8,290
E00174058,7,14,25,52,137,29,1,265
E00174214,5,8,12,51,131,19,1,227
E00174215,7,20,34,44,92,22,5,224
E00174218,2,8,24,132,233,11,6,416
E00174220,3,1,13,17,74,7,1,116
E00174221,4,9,16,21,110,14,8,182
E00174225,3,4,16,22,97,6,0,148
E00174226,6,9,29,66,139,25,5,279
E00174228,6,18,28,61,89,43,6,251
E00174229,25,50,51,53,110,76,14,379
E00174231,5,5,23,195,101,8,10,347
E00174232,9,15,15,43,175,36,9,302
E00174234,8,19,28,45,227,16,5,348
E00174237,10,20,29,67,112,40,7,285
E00174239,1,8,8,21,30,20,1,89
E00174243,4,1,16,65,201,13,6,306
E00174245,7,17,18,20,90,20,1,173
E00174246,8,18,18,45,73,40,4,206
E00174248,2,7,6,19,122,10,0,166
E00174249,2,11,17,159,240,23,9,461
E00174251,10,39,37,68,196,78,11,439
E00174253,8,16,17,35,111,32,6,225
E00174254,13,24,24,23,52,69,7,212
E00174256,5,7,13,22,203,7,5,262
E00174257,7,11,21,42,222,12,8,323
E00174259,12,20,41,46,105,42,7,273
E00174260,4,14,23,30,64,27,13,175
E00174262,0,19,24,64,177,18,5,307
E00174263,3,6,10,18,120,7,3,167
E00174273,12,25,27,46,79,58,8,255
E00174275,3,6,13,16,113,5,2,158
E00174276,9,15,10,30,147,14,0,225
E00174277,5,9,17,17,174,18,4,244
E00174278,10,7,14,65,281,13,4,394
E00174279,1,8,15,56,105,24,0,209
E00174280,10,18,23,26,63,54,5,199
E00174281,6,14,20,36,131,19,2,228
E00174282,7,18,23,52,228,24,1,353
E00174283,6,15,27,34,131,41,9,263
E00174284,3,9,6,23,230,13,6,290
E00174286,3,12,17,20,147,17,1,217
E00174287,5,6,8,24,123,11,2,179
E00174288,10,22,14,41,111,31,10,239
E00174289,4,10,14,50,150,12,1,241
E00174290,6,26,22,17,54,70,8,203
E00174291,10,16,27,47,171,22,1,294
E00174292,6,7,20,42,172,7,7,261
E00174293,6,8,29,213,236,24,14,530
E00174294,9,17,12,97,174,58,13,380
E00174295,2,6,32,679,144,6,6,875
E00174296,0,4,14,110,209,11,12,360
E00174298,0,4,24,227,104,9,4,372
E00174299,5,8,11,28,204,18,4,278
E00174300,0,7,7,33,154,4,2,207
E00174302,4,6,9,29,65,14,6,133
E00174303,1,2,8,33,145,4,4,197
E00174304,8,18,15,24,75,46,3,189
E00174305,4,22,22,24,39,46,6,163
E00174306,6,37,36,33,44,65,8,229
E00174307,3,2,14,139,303,12,11,484
E00174309,0,5,10,22,111,3,1,152
E00174311,0,3,6,20,129,1,1,160
E00174312,4,3,14,145,104,3,4,277
E00174313,4,13,18,29,94,10,0,168
E00174314,7,12,12,18,50,75,4,178
E00174315,8,19,44,43,166,21,7,308
E00174316,0,7,10,124,102,3,3,249
E00174317,2,3,4,13,87,3,0,112
E00174318,1,4,6,20,64,9,2,106
E00174319,6,13,20,28,37,55,6,165
E00174320,9,17,26,36,72,51,4,215
E00174321,1,6,32,419,122,16,10,606
E00174322,3,20,16,26,30,58,4,157
E00174323,8,31,26,26,43,53,6,193
E00174324,5,15,18,276,179,20,18,531
E00174325,1,6,15,65,224,19,10,340
E00174326,15,28,32,57,105,78,14,329
E00174327,9,22,44,55,117,41,10,298
E00174328,7,10,14,57,97,25,2,212
E00174329,10,27,28,48,115,37,5,270
E00174331,2,3,11,9,55,5,3,88
E00174332,3,2,20,33,159,13,0,230
E00174333,4,8,13,46,153,4,1,229
E00178043,5,6,13,59,113,20,3,219
E00178044,5,7,26,235,305,18,15,611
E00178045,9,11,16,100,169,15,20,340
E00178046,9,15,41,1254,284,10,41,1654
E00178047,7,9,20,22,125,9,3,195
E00178048,0,9,7,14,123,11,4,168
E00178049,6,5,10,29,166,9,5,230
E00178050,12,35,38,33,50,85,8,261
E00178051,7,43,48,27,47,48,15,235
E00178052,1,2,19,56,146,19,1,244
E00178053,1,6,12,35,287,3,1,345
E00178054,4,14,13,33,108,18,3,193
E00178055,2,1,9,14,66,2,6,100
E00178056,3,6,26,605,204,8,26,878
E00178057,16,16,35,76,217,38,9,407
E00178058,6,22,8,18,77,9,1,141
E00178059,5,12,20,37,183,11,0,268
E00178060,1,11,17,40,258,13,5,345
E00178061,10,17,18,49,198,18,0,310
E00178062,3,22,26,52,153,33,10,299
E00178063,15,15,12,11,44,48,3,148
E00178064,1,11,38,1914,147,4,15,2130
E00178065,4,8,13,25,132,2,3,187
E00178066,0,2,15,278,176,6,11,488
E00178067,10,20,19,20,61,35,9,174
E00178068,5,6,11,37,55,15,2,131
E00178069,2,5,16,41,299,5,1,369
E00178070,21,31,34,42,46,56,7,237
E00178071,3,9,18,24,98,30,7,189
E00178072,4,1,9,75,277,5,7,378
E00178073,0,1,7,27,143,1,4,183
E00178074,4,7,23,45,197,12,0,288
E00178075,1,4,9,9,80,5,1,109
E00178076,2,4,6,32,214,5,6,269
E00178077,4,4,4,11,68,4,3,98
E00178078,10,23,15,10,27,41,3,129
E00178079,6,10,27,71,315,10,9,448
E00178080,6,47,54,39,79,115,12,352
E00178081,2,8,9,22,64,18,1,124
E00178082,3,26,20,30,122,21,7,229
E00178083,4,14,18,151,170,9,14,380
E00178084,17,24,43,115,308,11,9,527
E00178085,8,6,4,11,58,5,8,100
E00178086,2,8,11,26,214,12,2,275
E00178087,14,30,36,69,129,53,10,341
E00178088,0,1,5,10,99,1,0,116
E00178089,11,29,38,42,57,104,17,298
E00178090,3,9,7,31,96,9,1,156
E00178091,11,15,19,48,94,38,0,225
E00178092,21,42,40,61,147,68,12,391
E00178093,0,3,8,14,130,3,7,165
E00178094,0,8,14,22,74,15,5,138
E00178095,2,10,13,23,61,20,4,133
E00178096,0,4,8,117,96,3,7,235
E00178097,2,10,8,19,85,3,0,127
E00178098,5,20,29,16,115,42,3,230
E00178099,13,11,32,37,102,11,9,215
E00178100,5,4,14,35,129,10,2,199
E00178101,5,6,11,33,155,6,0,216
E00178102,14,28,40,61,52,92,11,298
E00178103,7,9,5,32,168,3,2,226
E00178104,15,29,30,27,51,93,4,249
E00178105,0,5,5,10,93,9,1,123
E00178106,6,9,11,403,142,7,4,582
E00178107,1,10,19,22,76,8,2,138
E00178108,12,22,51,69,190,41,5,390
E00178109,3,4,6,15,147,3,3,181
E00178110,8,5,19,47,74,8,5,166
E00178111,2,2,3,28,63,4,1,103
E00178112,7,10,7,33,311,12,8,388
E00178113,13,31,26,30,75,47,8,230
E00178114,4,7,39,402,241,6,12,711
E00178115,1,3,3,14,91,1,3,116
E00178116,0,6,12,20,36,39,0,113
E00178117,11,16,31,55,258,66,17,454
E00178118,13,22,37,56,136,22,7,293
E00178119,22,26,38,38,31,75,8,238
