Row Labels,Household is deprived in four dimensions,Household is deprived in one dimension,Household is deprived in three dimensions,Household is deprived in two dimensions,Household is not deprived in any dimension,TotalDep
E00073143,0,46,1,17,86,150
E00073145,0,53,4,37,64,158
E00073147,0,70,10,24,72,176
E00073148,0,48,9,24,58,139
E00073150,1,61,5,29,92,188
E00073152,1,40,5,15,83,144
E00073153,0,67,8,17,105,197
E00073154,0,38,0,7,85,130
E00073155,0,42,1,10,94,147
E00073156,0,40,2,19,62,123
E00073157,0,50,0,17,90,157
E00073158,0,54,5,18,74,151
E00073159,0,30,2,12,83,127
E00073160,0,56,2,17,98,173
E00073161,1,57,9,18,74,159
E00073162,0,62,3,14,90,169
E00073163,0,31,0,12,77,120
E00073164,1,28,0,9,86,124
E00073165,0,48,2,15,68,133
E00073166,0,34,2,8,69,113
E00073167,0,60,3,24,103,190
E00073168,1,41,9,23,84,158
E00073169,0,63,4,20,106,193
E00073170,1,73,7,18,114,213
E00073171,0,74,5,25,99,203
E00073172,1,44,9,22,76,152
E00073173,1,45,3,13,76,138
E00073174,8,35,6,14,83,146
E00073176,0,64,8,19,81,172
E00073177,0,64,10,27,58,159
E00073178,0,50,4,15,75,144
E00073179,0,41,7,24,66,138
E00073181,2,71,13,45,71,202
E00073182,8,49,12,33,86,188
E00073183,0,35,4,26,66,131
E00073184,0,50,9,22,42,123
E00073185,0,49,11,28,56,144
E00073186,0,30,5,23,50,108
E00073187,1,41,10,31,64,147
E00073188,0,37,12,27,39,115
E00073189,1,46,3,17,53,120
E00073190,0,33,12,32,43,120
E00073191,0,39,13,25,49,126
E00073192,0,40,4,16,60,120
E00073193,0,47,1,13,77,138
E00073194,1,40,11,26,38,116
E00073195,2,41,11,12,67,133
E00073196,0,47,9,28,38,122
E00073197,0,60,5,28,86,179
E00073198,0,54,14,26,28,122
E00073199,0,38,4,20,43,105
E00073200,1,52,13,29,35,130
E00073201,1,40,4,13,60,118
E00073202,0,58,6,15,82,161
E00073203,0,50,2,14,77,143
E00073204,1,36,5,10,63,115
E00073205,1,52,3,23,89,168
E00073206,0,64,3,23,88,178
E00073207,0,53,3,24,57,137
E00073208,2,50,6,17,43,118
E00073209,2,54,11,32,37,136
E00073210,0,42,4,14,84,144
E00073211,0,71,8,31,85,195
E00073212,1,62,8,35,63,169
E00073213,2,51,7,25,74,159
E00073214,0,54,4,24,69,151
E00073215,1,42,15,30,20,108
E00073216,0,45,11,36,39,131
E00073217,0,55,4,19,63,141
E00073218,0,56,4,25,59,144
E00073219,0,48,18,39,33,138
E00073220,2,52,7,31,52,144
E00073221,0,49,3,20,59,131
E00073222,0,60,14,30,47,151
E00073223,0,41,1,15,73,130
E00073224,1,41,1,13,90,146
E00073225,0,59,6,13,123,201
E00073226,0,46,6,40,41,133
E00073227,0,36,8,14,82,140
E00073228,0,49,2,15,93,159
E00073229,0,38,3,16,59,116
E00073230,0,34,2,9,103,148
E00073231,0,46,1,18,94,159
E00073232,0,35,2,7,97,141
E00073233,1,31,0,6,78,116
E00073234,1,24,1,13,84,123
E00073236,2,38,1,8,75,124
E00073237,0,38,0,6,102,146
E00073238,0,27,2,5,96,130
E00073239,0,57,7,16,140,220
E00073240,1,43,5,17,93,159
E00073241,1,36,2,10,80,129
E00073242,0,43,1,15,52,111
E00073243,0,44,3,7,77,131
E00073245,0,52,4,19,67,142
E00073246,0,39,6,13,78,136
E00073247,0,36,2,15,69,122
E00073248,0,37,0,14,85,136
E00073249,2,44,17,54,17,134
E00073250,1,76,8,16,130,231
E00073251,0,46,8,17,85,156
E00073252,0,43,3,24,69,139
E00073253,1,64,11,29,111,216
E00073254,0,40,5,21,77,143
E00073255,0,65,10,26,100,201
E00073256,0,55,9,22,77,163
E00073257,0,45,0,20,74,139
E00073258,2,38,1,26,88,155
E00073259,0,31,8,15,59,113
E00073260,0,42,0,18,65,125
E00073261,0,53,7,41,45,146
E00073262,1,39,18,27,27,112
E00073263,0,44,0,9,99,152
E00073264,0,40,2,13,75,130
E00073266,0,31,0,5,97,133
E00073267,0,39,1,10,69,119
E00073268,0,45,0,17,111,173
E00073269,0,45,1,12,105,163
E00073270,0,34,2,11,90,137
E00073271,0,52,1,18,118,189
E00073272,0,42,1,11,75,129
E00073273,1,45,3,5,71,125
E00073274,0,35,3,8,71,117
E00073276,1,44,8,19,56,128
E00073277,0,36,0,9,83,128
E00073278,0,34,2,4,92,132
E00073280,0,21,1,7,89,118
E00073281,0,40,3,8,90,141
E00073282,0,30,0,7,90,127
E00073283,0,27,0,9,80,116
E00073284,1,44,13,25,32,115
E00073285,0,43,1,11,86,141
E00073286,2,33,3,9,105,152
E00073287,0,37,0,7,81,125
E00073288,0,35,1,9,82,127
E00073289,0,33,1,7,87,128
E00073290,0,27,1,0,91,119
E00073291,1,36,1,8,82,128
E00073292,0,52,2,10,134,198
E00073293,0,45,1,6,95,147
E00073294,0,46,2,10,90,148
E00073295,0,43,0,4,84,131
E00073296,0,31,1,8,73,113
E00073297,0,37,0,14,90,141
E00073298,0,68,4,17,99,188
E00073299,1,46,1,9,88,145
E00073300,0,27,1,1,78,107
E00073301,0,40,2,23,78,143
E00073302,0,52,9,39,48,148
E00073303,1,53,4,22,72,152
E00073304,0,54,5,26,34,119
E00073305,0,54,6,17,57,134
E00073306,0,44,0,17,48,109
E00073307,0,46,4,20,55,125
E00073308,0,47,14,21,44,126
E00073309,0,42,9,31,49,131
E00073310,1,31,18,44,54,148
E00073311,2,36,16,36,35,125
E00073312,0,55,12,35,41,143
E00073313,1,47,6,23,68,145
E00073314,2,45,11,31,33,122
E00073315,0,36,6,27,26,95
E00073316,0,45,11,30,31,117
E00073317,1,33,7,31,47,119
E00073318,0,50,15,30,33,128
E00073319,0,63,0,13,112,188
E00073320,0,52,3,12,93,160
E00073321,0,50,3,29,65,147
E00073322,0,41,1,17,75,134
E00073323,0,39,1,10,65,115
E00073324,0,32,2,18,89,141
E00073325,0,48,6,21,87,162
E00073326,1,57,8,44,38,148
E00073327,0,50,7,26,53,136
E00073328,0,44,6,21,66,137
E00073329,1,46,6,22,57,132
E00073330,0,46,8,23,69,146
E00073331,0,64,1,15,89,169
E00073332,0,39,0,9,69,117
E00073333,0,59,1,12,63,135
E00073334,1,38,4,18,64,125
E00073335,1,58,14,46,61,180
E00073336,0,46,1,13,55,115
E00073337,0,44,5,19,63,131
E00073338,0,41,1,17,57,116
E00073339,0,46,0,13,77,136
E00073340,0,35,3,13,89,140
E00073341,0,34,0,8,97,139
E00073342,0,56,5,25,83,169
E00073343,0,54,1,10,94,159
E00073344,0,39,0,12,72,123
E00073345,1,40,2,8,54,105
E00073346,0,41,1,18,75,135
E00073347,0,32,1,13,62,108
E00073348,0,37,1,11,89,138
E00073349,0,36,7,22,60,125
E00073350,0,59,7,26,75,167
E00073351,2,32,8,30,53,125
E00073352,2,37,13,31,44,127
E00073353,0,36,0,8,110,154
E00073354,2,37,10,30,48,127
E00073355,0,41,8,21,68,138
E00073356,0,46,4,23,76,149
E00073357,0,46,4,10,69,129
E00073358,0,49,3,11,61,124
E00073359,0,52,5,18,52,127
E00073360,0,44,0,16,58,118
E00073361,1,25,5,22,67,120
E00073362,0,58,9,24,98,189
E00073363,0,44,4,22,64,134
E00073364,4,38,14,24,51,131
E00073365,0,40,3,14,66,123
E00073366,0,50,4,21,97,172
E00073367,0,39,1,17,75,132
E00073368,0,35,8,16,55,114
E00073369,0,46,8,21,50,125
E00073370,0,48,12,36,34,130
E00073371,0,42,4,29,35,110
E00073372,4,40,13,32,27,116
E00073373,0,32,2,12,70,116
E00073374,0,35,4,9,91,139
E00073375,0,48,3,14,70,135
E00073376,0,35,5,17,57,114
E00073377,0,36,5,8,71,120
E00073378,0,32,0,10,81,123
E00073379,0,49,3,6,86,144
E00073380,0,61,4,15,67,147
E00073381,0,56,4,18,82,160
E00073382,0,53,3,8,75,139
E00073383,6,50,21,44,34,155
E00073384,0,54,3,17,107,181
E00073385,0,42,7,24,57,130
E00073386,0,48,13,25,98,184
E00073387,0,42,9,32,42,125
E00073388,0,41,2,5,70,118
E00073389,1,49,3,18,80,151
E00073390,0,49,5,19,77,150
E00073391,0,30,6,17,79,132
E00073392,1,49,5,30,68,153
E00073393,0,48,3,17,59,127
E00073394,0,60,8,27,105,200
E00073395,0,52,8,35,33,128
E00073397,0,30,1,12,70,113
E00073398,0,28,0,14,77,119
E00073399,0,32,6,22,69,129
E00073400,0,43,1,9,74,127
E00073401,0,40,2,14,78,134
E00073402,1,36,0,12,71,120
E00073403,0,29,2,16,83,130
E00073404,0,36,1,11,84,132
E00073405,0,45,0,15,82,142
E00073406,0,36,0,12,72,120
E00073407,0,44,1,15,97,157
E00073408,0,37,1,13,79,130
E00073409,0,38,2,8,62,110
E00073410,0,40,0,10,80,130
E00073411,0,48,1,7,70,126
E00073412,0,46,0,14,94,154
E00073413,0,36,3,9,71,119
E00073414,0,32,7,24,55,118
E00073415,0,36,2,6,59,103
E00073416,0,44,1,6,85,136
E00073419,2,60,4,15,78,159
E00073420,0,34,1,12,43,90
E00073421,0,45,1,14,44,104
E00073422,0,40,17,32,29,118
E00073423,2,50,2,19,43,116
E00073424,2,47,10,27,39,125
E00073425,0,54,1,14,64,133
E00073426,0,51,0,13,61,125
E00073431,3,81,3,21,78,186
E00073432,5,22,17,19,30,93
E00073433,1,78,2,24,76,181
E00073437,0,39,4,10,82,135
E00073439,0,43,0,10,94,147
E00073440,2,45,4,12,65,128
E00073441,2,49,14,22,45,132
E00073442,0,55,2,9,102,168
E00073443,0,31,1,8,77,117
E00073444,3,32,3,11,67,116
E00073445,0,37,2,8,66,113
E00073446,0,67,2,18,73,160
E00073447,1,30,8,22,63,124
E00073448,0,34,2,14,69,119
E00073449,0,43,1,5,66,115
E00073450,0,34,1,3,89,127
E00073451,1,33,2,8,102,146
E00073452,0,49,0,9,93,151
E00073453,0,52,2,18,78,150
E00073454,0,43,1,11,103,158
E00073455,0,43,2,9,89,143
E00073456,1,38,1,8,84,132
E00073457,0,46,0,6,65,117
E00073458,0,37,1,10,80,128
E00073461,0,30,1,9,74,114
E00073462,0,48,1,7,85,141
E00073463,0,65,6,22,35,128
E00073464,0,42,1,8,83,134
E00073465,0,47,2,9,98,156
E00073466,0,54,1,9,98,162
E00073467,0,38,1,7,96,142
E00073468,1,39,2,5,95,142
E00073469,0,28,0,1,89,118
E00073470,0,43,0,7,138,188
E00073471,1,39,8,7,50,105
E00073472,0,31,2,3,90,126
E00073473,6,29,9,21,27,92
E00073474,0,15,0,3,62,80
E00073476,0,43,2,10,77,132
E00073477,2,40,0,6,90,138
E00073478,1,38,0,4,83,126
E00073479,0,35,1,9,76,121
E00073480,0,46,1,9,89,145
E00073481,0,56,0,8,156,220
E00073482,0,58,0,16,99,173
E00073483,0,47,1,14,95,157
E00073484,0,37,2,12,73,124
E00073485,1,42,3,25,44,115
E00073486,0,53,2,15,85,155
E00073487,0,46,1,16,65,128
E00073488,0,31,0,5,81,117
E00073489,0,30,0,5,78,113
E00073490,1,35,5,11,79,131
E00073491,1,36,0,9,89,135
E00073492,0,46,1,5,91,143
E00073493,0,33,3,16,83,135
E00073494,0,47,1,15,72,135
E00073495,0,29,5,14,63,111
E00073496,2,45,4,22,98,171
E00073497,0,40,0,13,72,125
E00073498,0,35,1,5,71,112
E00073499,0,37,0,10,68,115
E00073500,0,52,0,8,97,157
E00073501,0,34,0,14,81,129
E00073502,0,41,0,10,89,140
E00073503,0,37,2,8,85,132
E00073504,0,51,0,15,60,126
E00073505,0,38,2,11,49,100
E00073506,0,36,2,15,81,134
E00073507,0,32,0,13,52,97
E00073508,0,31,0,8,68,107
E00073509,0,41,0,8,77,126
E00073510,0,29,1,9,85,124
E00073511,0,28,4,18,76,126
E00073512,0,29,0,10,86,125
E00073513,0,44,0,5,109,158
E00073514,1,47,1,10,81,140
E00073515,0,26,0,12,89,127
E00073516,0,56,0,12,84,152
E00073517,1,33,3,18,77,132
E00073518,0,40,1,7,68,116
E00073519,0,36,3,18,80,137
E00073520,0,46,3,16,101,166
E00073521,0,35,2,15,72,124
E00073522,0,39,1,4,76,120
E00073523,0,38,2,12,79,131
E00073524,0,37,1,10,79,127
E00073525,0,37,1,8,110,156
E00073526,1,41,1,17,63,123
E00073527,1,55,6,14,67,143
E00073528,0,40,4,8,66,118
E00073529,1,52,3,21,61,138
E00073530,0,51,1,8,69,129
E00073531,0,39,2,6,93,140
E00073532,0,75,2,13,127,217
E00073533,0,29,0,7,77,113
E00073534,0,34,1,10,74,119
E00073535,0,31,1,3,68,103
E00073536,0,34,5,9,66,114
E00073537,0,42,1,6,94,143
E00073538,0,24,1,8,86,119
E00073539,0,31,7,8,64,110
E00073540,0,31,2,10,57,100
E00073541,0,40,2,10,66,118
E00073542,0,40,3,13,70,126
E00073543,2,36,14,12,69,133
E00073544,0,39,1,18,69,127
E00073545,0,61,5,16,105,187
E00073546,0,45,1,20,61,127
E00073547,0,54,7,8,76,145
E00073548,1,40,1,26,75,143
E00073549,0,42,4,8,99,153
E00073550,0,35,0,6,78,119
E00073551,0,39,2,15,58,114
E00073552,1,36,2,12,67,118
E00073553,0,33,0,11,69,113
E00073554,0,38,1,6,59,104
E00073555,0,37,1,5,83,126
E00073556,0,41,2,16,42,101
E00073557,0,40,0,5,68,113
E00073558,1,45,1,11,81,139
E00073559,0,51,2,18,71,142
E00073560,3,45,10,26,73,157
E00073561,0,51,6,30,84,171
E00073562,1,41,5,26,85,158
E00073563,0,55,4,15,70,144
E00073564,0,46,0,18,89,153
E00073565,1,81,17,55,80,234
E00073566,1,30,15,25,44,115
E00073567,1,41,9,18,68,137
E00073568,1,45,1,21,87,155
E00073569,0,53,2,20,100,175
E00073570,0,41,3,15,83,142
E00073571,0,54,3,24,90,171
E00073572,0,39,6,11,83,139
E00073573,0,63,9,34,109,215
E00073574,1,51,5,31,60,148
E00073575,1,61,9,31,81,183
E00073576,0,39,5,17,89,150
E00073577,0,54,3,21,67,145
E00073578,1,39,4,16,75,135
E00073579,2,29,7,20,45,103
E00073580,4,46,9,24,88,171
E00073581,0,49,3,15,73,140
E00073582,0,31,2,13,91,137
E00073583,0,50,2,16,86,154
E00073584,0,44,5,18,76,143
E00073585,0,52,3,17,87,159
E00073586,1,45,5,14,66,131
E00073587,0,42,2,13,94,151
E00073588,1,46,9,34,26,116
E00073589,1,37,7,20,22,87
E00073590,0,75,13,26,106,220
E00073591,1,41,7,19,55,123
E00073592,0,34,5,10,64,113
E00073593,0,35,5,9,72,121
E00073594,0,53,4,5,81,143
E00073595,2,44,2,19,71,138
E00073596,0,47,3,22,67,139
E00073597,0,75,13,53,94,235
E00073598,0,68,10,20,84,182
E00073599,0,44,2,23,49,118
E00073600,0,39,4,24,55,122
E00073601,2,32,5,10,69,118
E00073602,0,47,2,15,77,141
E00073603,0,46,10,21,67,144
E00073604,0,47,1,16,71,135
E00073605,0,37,3,19,59,118
E00073606,0,47,2,13,85,147
E00073607,2,48,11,26,50,137
E00073608,0,36,5,22,62,125
E00073609,1,53,6,21,65,146
E00073611,1,53,7,26,75,162
E00073612,2,56,8,33,49,148
E00073613,0,46,6,22,65,139
E00073614,1,61,8,30,127,227
E00073615,0,47,3,16,81,147
E00073616,0,47,4,16,65,132
E00073617,0,49,1,10,58,118
E00073618,0,32,3,14,77,126
E00073619,0,37,0,15,82,134
E00073620,0,51,0,8,71,130
E00073621,0,44,0,11,91,146
E00073622,0,41,3,18,65,127
E00073623,0,49,2,14,65,130
E00073624,1,37,10,35,29,112
E00073625,0,42,1,15,70,128
E00073626,0,46,11,22,61,140
E00073627,0,77,4,24,98,203
E00073628,3,34,19,26,39,121
E00073629,0,54,5,16,70,145
E00073630,5,68,5,24,95,197
E00073631,0,41,0,11,71,123
E00073632,0,32,6,19,77,134
E00073633,0,43,6,12,56,117
E00073634,4,63,16,31,85,199
E00073635,0,46,3,20,75,144
E00073636,1,45,9,43,38,136
E00073637,1,50,16,24,41,132
E00073638,2,45,10,28,40,125
E00073639,0,52,5,24,66,147
E00073640,0,50,14,27,36,127
E00073641,3,39,8,33,48,131
E00073642,1,48,13,30,44,136
E00073643,0,51,12,38,43,144
E00073644,1,46,13,34,35,129
E00073645,1,39,14,29,27,110
E00073646,1,65,11,53,69,199
E00073647,0,52,9,20,65,146
E00073648,3,40,15,47,29,134
E00073649,2,37,9,31,42,121
E00073650,0,44,17,30,36,127
E00073651,2,63,5,19,71,160
E00073652,0,41,25,33,35,134
E00073653,2,36,19,28,27,112
E00073654,3,41,7,27,44,122
E00073655,0,45,16,31,51,143
E00073656,1,56,12,26,50,145
E00073657,0,42,16,17,38,113
E00073658,0,35,10,46,34,125
E00073659,1,41,6,25,48,121
E00073660,0,42,17,33,49,141
E00073662,0,39,17,46,42,144
E00073663,2,44,8,35,35,124
E00073664,1,31,24,40,20,116
E00073665,3,47,21,37,37,145
E00073666,0,38,0,16,93,147
E00073667,0,68,13,28,66,175
E00073668,0,40,5,29,42,116
E00073669,0,42,6,18,35,101
E00073670,3,50,15,28,29,125
E00073671,2,51,7,23,37,120
E00073672,0,39,2,20,83,144
E00073673,0,43,7,33,37,120
E00073674,0,47,19,15,71,152
E00073675,0,44,0,5,59,108
E00073676,1,45,1,19,74,140
E00073677,0,31,12,44,48,135
E00073678,1,40,13,35,28,117
E00073679,1,39,10,33,30,113
E00073680,1,36,17,53,24,131
E00073681,0,37,6,22,49,114
E00073682,0,46,4,24,56,130
E00073683,0,50,4,38,74,166
E00073684,0,41,5,22,51,119
E00073685,0,36,5,15,72,128
E00073688,1,35,13,22,50,121
E00073689,0,34,1,10,77,122
E00073690,0,29,1,14,76,120
E00073691,0,44,2,11,72,129
E00073692,0,49,9,18,78,154
E00073693,2,77,6,37,86,208
E00073695,0,50,1,14,63,128
E00073696,0,51,3,22,53,129
E00073697,0,42,6,18,71,137
E00073698,1,77,4,42,84,208
E00073699,0,49,5,24,54,132
E00073700,0,30,6,33,48,117
E00073701,1,34,1,15,60,111
E00073702,0,33,2,21,55,111
E00073703,0,49,12,19,35,115
E00073704,0,44,2,10,69,125
E00073705,0,42,1,13,80,136
E00073706,0,43,7,25,61,136
E00073707,0,42,7,25,47,121
E00073708,0,62,6,25,60,153
E00073709,2,41,11,19,40,113
E00073710,0,47,10,27,36,120
E00073711,0,51,7,20,89,167
E00073712,1,40,22,32,26,121
E00073713,0,61,13,68,36,178
E00073714,3,38,12,30,37,120
E00073715,0,52,9,44,43,148
E00073716,0,38,21,31,25,115
E00073717,0,27,16,37,47,127
E00073718,0,48,6,16,54,124
E00073719,2,72,16,45,65,200
E00073720,0,41,13,33,49,136
E00073721,0,38,9,33,42,122
E00073722,0,52,16,25,34,127
E00073723,0,50,10,37,62,159
E00073724,0,54,27,49,44,174
E00073725,0,34,7,26,44,111
E00073726,0,37,18,33,33,121
E00073727,0,34,16,21,42,113
E00073728,1,52,4,28,40,125
E00073729,0,46,12,30,43,131
E00073730,0,30,9,35,40,114
E00073731,2,36,15,31,35,119
E00073732,0,48,11,36,30,125
E00073733,2,35,15,29,34,115
E00073734,0,43,2,15,51,111
E00073735,0,28,0,12,87,127
E00073736,0,36,1,9,69,115
E00073737,0,33,1,21,71,126
E00073738,0,57,0,12,58,127
E00073739,0,49,1,9,73,132
E00073740,0,43,2,10,63,118
E00073741,0,50,0,15,56,121
E00073743,0,41,0,20,75,136
E00073744,0,56,7,22,51,136
E00073745,2,39,17,36,17,111
E00073746,1,34,0,7,81,123
E00073747,0,50,0,9,71,130
E00073748,1,59,15,43,107,225
E00073749,0,47,0,10,73,130
E00073750,1,44,10,31,41,127
E00073751,2,51,13,30,43,139
E00073752,1,73,9,37,120,240
E00073754,0,61,14,42,57,174
E00073755,2,44,13,31,45,135
E00073756,0,48,11,21,33,113
E00073757,0,43,5,10,68,126
E00073758,0,58,11,20,61,150
E00073759,0,42,9,31,60,142
E00073760,0,37,2,25,83,147
E00073761,0,42,6,31,81,160
E00073762,0,52,3,11,62,128
E00073763,0,43,4,20,58,125
E00073764,0,58,8,33,56,155
E00073765,0,42,1,17,61,121
E00073766,0,51,12,40,39,142
E00073767,1,42,8,36,60,147
E00073768,0,53,6,26,59,144
E00073769,0,44,8,25,57,134
E00073770,0,39,5,23,51,118
E00073771,0,46,10,16,58,130
E00073772,1,41,8,19,57,126
E00073773,0,40,7,30,51,128
E00073774,0,49,6,26,87,168
E00073775,1,53,11,22,76,163
E00073776,0,55,11,27,41,134
E00073777,0,51,5,18,42,116
E00073778,0,42,7,12,58,119
E00073779,0,34,1,8,72,115
E00073780,1,39,10,21,43,114
E00073781,0,47,3,11,74,135
E00073782,0,65,3,21,64,153
E00073783,0,49,0,19,72,140
E00073784,0,72,6,20,117,215
E00073785,2,36,11,32,52,133
E00073786,0,49,13,52,60,174
E00073787,0,40,3,17,74,134
E00073788,0,49,1,16,69,135
E00073789,0,44,2,13,69,128
E00073790,0,56,7,22,94,179
E00073791,0,49,16,34,37,136
E00073792,1,53,9,36,56,155
E00073793,0,36,1,19,79,135
E00073794,0,63,2,16,82,163
E00073795,0,41,5,22,75,143
E00073796,3,45,25,49,26,148
E00073797,0,44,2,11,57,114
E00073798,0,57,3,24,61,145
E00073799,0,64,7,27,66,164
E00073800,0,32,17,35,33,117
E00073801,0,39,6,17,72,134
E00073802,1,55,7,24,55,142
E00073803,0,47,5,17,55,124
E00073804,0,36,5,16,52,109
E00073805,0,34,8,17,55,114
E00073806,0,40,0,10,60,110
E00073807,0,50,5,22,53,130
E00073808,0,61,2,19,45,127
E00073809,0,36,2,15,76,129
E00073810,0,42,0,11,60,113
E00073811,0,39,1,22,69,131
E00073812,0,41,10,24,56,131
E00073813,1,45,1,16,63,126
E00073814,1,52,2,17,86,158
E00073815,1,48,4,20,74,147
E00073816,0,47,5,28,42,122
E00073817,0,54,20,41,55,170
E00073818,0,39,1,12,90,142
E00073819,0,49,1,11,71,132
E00073820,0,26,3,1,75,105
E00073821,0,43,8,30,45,126
E00073822,0,32,1,14,107,154
E00073823,0,37,5,8,71,121
E00073824,0,34,0,4,86,124
E00073825,0,30,0,3,92,125
E00073826,0,32,1,4,87,124
E00073827,0,30,1,4,94,129
E00073828,0,28,0,5,84,117
E00073829,0,26,0,3,81,110
E00073830,0,38,2,4,75,119
E00073831,0,25,2,7,80,114
E00073832,1,29,2,7,66,105
E00073833,0,43,2,7,85,137
E00073834,0,41,1,10,77,129
E00073835,0,45,0,7,93,145
E00073836,0,39,3,16,48,106
E00073837,0,57,3,25,87,172
E00073838,0,29,0,4,99,132
E00073839,0,30,0,7,81,118
E00073840,0,24,2,6,90,122
E00073841,0,31,0,5,91,127
E00073842,0,34,0,1,98,133
E00073843,0,38,1,12,82,133
E00073844,0,43,0,12,79,134
E00073845,0,45,0,9,76,130
E00073846,0,35,0,17,74,126
E00073847,0,55,5,17,66,143
E00073848,0,30,0,7,83,120
E00073849,0,25,0,7,90,122
E00073850,0,31,1,3,83,118
E00073851,0,36,1,3,71,111
E00073852,1,38,6,32,52,129
E00073853,0,45,1,10,69,125
E00073854,0,44,4,12,74,134
E00073855,0,37,7,27,62,133
E00073856,0,37,6,18,65,126
E00073857,0,61,2,24,88,175
E00073858,0,35,3,19,66,123
E00073859,1,62,6,21,149,239
E00073860,0,32,21,33,17,103
E00073861,1,48,3,22,84,158
E00073862,1,69,2,34,134,240
E00073864,0,76,0,29,119,224
E00073865,0,48,1,12,71,132
E00073866,0,43,5,19,85,152
E00073867,0,39,6,22,61,128
E00073868,0,40,1,15,72,128
E00073869,0,42,2,16,63,123
E00073870,0,43,6,29,56,134
E00073871,3,38,16,36,26,119
E00073872,0,54,5,15,67,141
E00073873,0,53,15,23,41,132
E00073874,0,46,7,37,42,132
E00073875,1,42,6,17,89,155
E00073876,2,51,11,36,28,128
E00073877,1,45,4,24,73,147
E00073878,1,45,18,34,27,125
E00073879,1,58,11,32,43,145
E00073880,1,46,13,26,64,150
E00073881,0,48,1,22,55,126
E00073882,0,43,9,17,55,124
E00073883,0,51,9,28,49,137
E00073884,0,47,9,15,51,122
E00073885,1,55,3,15,56,130
E00073886,0,44,2,13,67,126
E00073887,0,47,7,13,69,136
E00073888,0,46,3,23,53,125
E00073889,1,46,4,20,54,125
E00073890,0,40,4,35,55,134
E00073891,0,56,6,20,53,135
E00073892,0,38,2,8,82,130
E00073893,0,36,0,9,100,145
E00073894,1,42,0,10,90,143
E00073895,1,43,3,11,62,120
E00073896,0,54,8,32,52,146
E00073897,0,47,3,13,87,150
E00073898,0,42,5,14,75,136
E00073899,0,51,0,24,59,134
E00073900,0,43,2,13,89,147
E00073901,0,58,0,7,84,149
E00073902,0,25,2,15,71,113
E00073904,0,48,2,13,88,151
E00073905,0,71,0,24,138,233
E00073906,0,34,2,24,86,146
E00073907,0,30,2,7,97,136
E00073908,1,45,11,23,50,130
E00073909,0,43,15,34,36,128
E00073910,0,39,10,29,39,117
E00073911,0,32,0,6,79,117
E00073912,0,51,8,18,85,162
E00073913,0,41,7,21,70,139
E00073914,0,37,1,12,89,139
E00073915,0,52,1,24,68,145
E00073916,0,47,0,4,71,122
E00073917,0,35,3,8,90,136
E00073918,0,55,4,31,79,169
E00073919,0,50,17,31,67,165
E00073921,1,27,13,30,38,109
E00073922,0,41,2,12,81,136
E00073923,2,48,4,26,66,146
E00073925,2,43,5,15,90,155
E00073926,1,55,1,15,90,162
E00073927,0,40,1,14,84,139
E00073928,0,53,3,12,68,136
E00073929,0,33,6,20,66,125
E00073930,0,32,9,20,62,123
E00073931,0,43,5,22,42,112
E00073932,0,43,4,20,54,121
E00073933,0,37,19,18,39,113
E00073934,0,39,3,26,48,116
E00073935,0,48,4,18,51,121
E00073936,2,41,13,28,28,112
E00073937,1,42,5,27,50,125
E00073938,2,40,17,30,34,123
E00073939,0,39,6,27,57,129
E00073940,0,31,9,26,39,105
E00073941,0,41,6,24,50,121
E00073942,1,56,12,33,33,135
E00073943,3,49,8,24,56,140
E00073944,1,38,13,25,39,116
E00073945,1,45,12,24,43,125
E00073946,0,54,5,32,51,142
E00073947,0,35,5,23,48,111
E00073948,0,32,3,30,35,100
E00073949,2,38,16,39,32,127
E00073950,1,58,17,56,36,168
E00073951,0,42,14,34,35,125
E00073952,0,40,7,19,50,116
E00073953,1,45,4,16,47,113
E00073954,1,40,15,35,30,121
E00073955,0,52,1,3,87,143
E00073956,0,30,1,17,75,123
E00073957,0,46,3,26,59,134
E00073958,0,31,4,24,72,131
E00073959,0,33,3,8,93,137
E00073960,0,34,0,12,82,128
E00073961,0,36,7,27,59,129
E00073962,0,33,3,9,74,119
E00073963,0,46,2,17,85,150
E00073964,0,56,9,22,43,130
E00073965,0,31,4,25,55,115
E00073966,0,48,14,18,42,122
E00073967,0,31,2,5,87,125
E00073968,1,42,1,12,81,137
E00073969,0,31,5,25,82,143
E00073970,0,40,2,10,72,124
E00073971,0,40,1,5,82,128
E00073972,0,33,4,12,77,126
E00073973,1,53,3,26,59,142
E00073974,0,52,3,27,93,175
E00073975,0,33,1,12,77,123
E00073976,0,38,1,17,68,124
E00073977,0,44,1,19,109,173
E00073978,0,40,1,8,80,129
E00073979,0,36,0,8,82,126
E00073980,0,47,5,14,66,132
E00073981,0,44,7,23,47,121
E00073982,0,52,8,31,52,143
E00073983,0,45,2,11,81,139
E00073984,0,47,1,20,83,151
E00073985,0,39,5,28,50,122
E00073986,0,40,0,12,84,136
E00073987,0,54,5,33,49,141
E00073988,0,37,8,27,57,129
E00073989,0,47,8,28,66,149
E00073990,0,47,12,22,65,146
E00073991,0,47,8,21,93,169
E00073992,0,47,7,15,61,130
E00073993,0,48,11,23,52,134
E00073994,0,38,9,22,57,126
E00073995,0,39,12,27,49,127
E00073996,0,46,2,20,70,138
E00073997,1,40,11,34,35,121
E00073998,3,51,17,32,38,141
E00073999,3,47,14,28,31,123
E00074000,0,50,8,20,36,114
E00074001,2,53,11,16,58,140
E00074002,2,74,20,41,67,204
E00074003,1,59,13,38,80,191
E00074006,1,66,9,49,42,167
E00074007,0,42,1,9,103,155
E00074008,2,49,4,34,53,142
E00074009,1,58,14,44,57,174
E00074010,13,71,22,51,44,201
E00074011,0,43,12,28,45,128
E00074012,1,53,14,38,27,133
E00074013,0,49,13,21,67,150
E00074014,0,50,7,23,83,163
E00074016,0,65,37,33,48,183
E00074018,1,59,10,41,80,191
E00074019,2,70,21,36,37,166
E00074020,2,58,8,23,86,177
E00074021,2,45,11,31,29,118
E00074022,1,56,18,35,74,184
E00074023,2,86,22,54,66,230
E00074024,0,40,9,31,52,132
E00074025,3,60,20,51,44,178
E00074026,0,58,8,50,81,197
E00074027,0,48,20,32,28,128
E00074028,3,91,11,50,50,205
E00074029,1,68,28,61,47,205
E00074030,0,61,9,37,13,120
E00074032,5,57,23,47,36,168
E00074033,1,67,16,43,27,154
E00074034,0,47,5,25,36,113
E00074037,1,41,17,35,25,119
E00074038,4,61,18,40,18,141
E00074041,2,33,20,34,37,126
E00074042,1,51,5,26,19,102
E00074045,0,45,6,23,43,117
E00074046,0,50,3,30,68,151
E00074047,1,51,8,27,36,123
E00074048,0,42,2,19,66,129
E00074049,1,53,9,27,58,148
E00074050,0,42,8,23,40,113
E00074051,0,44,0,13,93,150
E00074052,0,37,2,10,67,116
E00074053,0,58,4,15,80,157
E00074054,0,53,7,25,38,123
E00074055,0,65,2,18,91,176
E00074056,0,46,2,22,63,133
E00074057,0,49,4,27,72,152
E00074058,0,59,1,16,88,164
E00074060,0,53,9,48,63,173
E00074061,0,55,8,36,51,150
E00074062,0,56,4,37,52,149
E00074063,0,36,3,16,47,102
E00074064,0,41,10,22,49,122
E00074065,1,52,8,24,46,131
E00074066,0,54,7,21,44,126
E00074067,1,41,5,16,52,115
E00074068,0,27,8,21,25,81
E00074069,1,47,8,24,40,120
E00074070,1,49,23,48,31,152
E00074071,0,24,21,32,25,102
E00074072,0,48,8,19,51,126
E00074073,0,31,2,30,61,124
E00074074,1,48,7,30,33,119
E00074075,0,33,0,15,69,117
E00074076,2,42,7,20,53,124
E00074077,0,51,6,34,53,144
E00074078,0,30,2,12,77,121
E00074079,0,27,0,5,85,117
E00074080,0,38,1,8,68,115
E00074081,0,70,4,16,150,240
E00074082,0,42,0,16,63,121
E00074083,1,36,3,15,66,121
E00074084,0,42,3,13,70,128
E00074085,0,36,1,17,59,113
E00074086,0,39,0,10,73,122
E00074087,1,37,1,9,94,142
E00074088,2,71,2,19,101,195
E00074089,0,44,6,11,91,152
E00074090,0,34,3,16,77,130
E00074091,0,30,0,8,64,102
E00074092,0,27,2,12,85,126
E00074093,0,41,4,12,97,154
E00074094,0,35,3,10,81,129
E00074095,0,36,1,2,86,125
E00074096,0,39,2,14,72,127
E00074097,0,38,0,1,83,122
E00074098,0,30,0,2,80,112
E00074099,0,23,2,6,86,117
E00074100,0,32,0,5,87,124
E00074101,11,43,5,2,69,130
E00074102,0,33,3,4,73,113
E00074103,0,49,1,5,88,143
E00074104,0,44,7,21,78,150
E00074105,1,55,3,8,121,188
E00074106,0,23,1,3,79,106
E00074107,0,53,4,11,65,133
E00074108,0,30,1,17,92,140
E00074109,0,44,0,6,105,155
E00074110,0,35,2,20,77,134
E00074111,0,45,3,5,69,122
E00074112,1,51,2,21,59,134
E00074113,0,33,0,6,83,122
E00074114,0,25,4,9,85,123
E00074115,2,62,9,20,58,151
E00074116,1,70,8,28,86,193
E00074117,0,37,3,9,77,126
E00074118,0,37,6,18,73,134
E00074119,0,69,3,21,109,202
E00074120,0,52,0,16,95,163
E00074121,0,39,4,18,79,140
E00074122,0,34,10,20,46,110
E00074123,1,57,12,41,45,156
E00074124,0,44,1,22,67,134
E00074125,0,41,3,15,75,134
E00074126,0,40,4,21,87,152
E00074127,0,43,5,16,69,133
E00074128,2,45,4,19,72,142
E00074129,0,46,8,20,65,139
E00074130,0,44,4,12,81,141
E00074131,0,39,1,5,110,155
E00074132,0,42,4,15,64,125
E00074133,0,42,2,11,64,119
E00074134,0,47,2,18,67,134
E00074135,1,54,7,16,91,169
E00074136,0,53,6,17,70,146
E00074137,0,48,3,15,82,148
E00074138,0,47,0,7,67,121
E00074139,0,43,1,5,105,154
E00074140,0,51,5,14,58,128
E00074141,0,61,3,9,61,134
E00074142,0,41,0,12,79,132
E00074143,1,44,10,22,73,150
E00074144,0,40,2,10,78,130
E00074145,0,42,2,13,80,137
E00074146,0,48,2,15,90,155
E00074147,0,60,2,19,95,176
E00074148,0,35,0,19,67,121
E00074149,0,60,4,27,90,181
E00074150,0,42,9,15,40,106
E00074151,0,49,7,29,63,148
E00074152,0,47,4,23,54,128
E00074153,0,56,6,26,61,149
E00074154,0,41,6,29,53,129
E00074155,0,57,12,32,80,181
E00074156,4,62,15,58,61,200
E00074157,0,42,9,19,63,133
E00074158,0,42,7,26,76,151
E00074159,3,46,16,22,44,131
E00074160,0,41,2,22,59,124
E00074161,2,57,13,29,108,209
E00074162,1,34,12,23,45,115
E00074163,0,53,4,16,55,128
E00074164,0,44,1,18,66,129
E00074165,0,47,4,25,54,130
E00074166,0,62,4,14,97,177
E00074167,3,46,4,25,47,125
E00074168,0,48,4,28,68,148
E00074169,0,40,0,13,82,135
E00074170,2,48,10,23,84,167
E00074171,1,47,7,25,66,146
E00074172,0,51,5,19,77,152
E00074173,1,55,2,10,80,148
E00074174,0,77,9,28,123,237
E00074175,0,59,6,27,82,174
E00074176,0,37,2,18,82,139
E00074177,0,46,3,15,55,119
E00074178,0,54,7,23,85,169
E00074179,0,45,0,16,71,132
E00074180,0,59,8,30,82,179
E00074181,0,64,8,19,91,182
E00074182,4,53,19,33,34,143
E00074183,0,30,3,18,62,113
E00074184,1,44,2,19,65,131
E00074185,1,43,2,9,75,130
E00074186,1,44,1,17,105,168
E00074187,0,47,4,12,74,137
E00074188,0,36,2,9,55,102
E00074189,0,38,3,10,76,127
E00074190,1,48,3,11,74,137
E00074191,2,55,14,16,96,183
E00074193,4,48,11,40,28,131
E00074194,0,39,4,25,39,107
E00074195,0,46,5,14,70,135
E00074197,1,42,10,29,33,115
E00074198,0,49,6,23,48,126
E00074199,0,39,11,35,54,139
E00074200,1,45,8,23,51,128
E00074201,0,47,7,36,73,163
E00074202,2,62,10,24,63,161
E00074203,0,38,13,35,25,111
E00074204,2,58,10,26,88,184
E00074205,0,53,2,28,48,131
E00074206,1,42,14,30,32,119
E00074207,1,51,12,22,46,132
E00074208,0,37,9,27,55,128
E00074209,0,49,15,39,49,152
E00074210,0,39,15,34,34,122
E00074211,0,49,11,35,29,124
E00074212,0,37,0,16,81,134
E00074213,1,81,14,55,72,223
E00074214,0,44,9,24,77,154
E00074215,3,46,19,18,43,129
E00074216,2,44,7,27,38,118
E00074217,0,42,10,33,44,129
E00074218,3,43,10,27,36,119
E00074219,0,48,9,24,53,134
E00074220,0,65,10,29,51,155
E00074221,0,43,7,30,46,126
E00074222,1,37,3,26,42,109
E00074223,0,44,0,15,65,124
E00074224,0,39,2,12,59,112
E00074225,0,43,1,22,64,130
E00074226,0,52,0,13,76,141
E00074227,0,47,10,22,48,127
E00074228,0,49,3,13,115,180
E00074229,4,53,25,41,43,166
E00074230,0,41,4,9,106,160
E00074231,0,35,0,17,77,129
E00074232,1,54,18,34,19,126
E00074233,1,54,18,28,34,135
E00074234,0,36,3,12,78,129
E00074235,2,40,12,48,46,148
E00074236,0,41,3,13,86,143
E00074237,2,39,1,16,113,171
E00074238,0,57,3,21,79,160
E00074240,1,36,2,11,100,150
E00074241,0,41,2,5,84,132
E00074243,0,46,0,6,90,142
E00074244,0,45,1,11,107,164
E00074245,0,22,1,13,79,115
E00074246,0,37,0,4,86,127
E00074247,0,36,8,14,111,169
E00074248,0,29,0,12,88,129
E00074250,0,29,4,7,89,129
E00074251,0,26,0,7,94,127
E00074252,0,42,0,6,83,131
E00074253,2,42,2,10,68,124
E00074254,0,46,10,29,48,133
E00074255,0,39,25,42,15,121
E00074256,0,24,0,8,94,126
E00074257,0,40,7,9,117,173
E00074258,0,63,3,8,159,233
E00074259,0,63,15,38,32,148
E00074260,0,30,1,14,82,127
E00074261,0,33,1,16,97,147
E00074262,0,39,4,19,68,130
E00074263,0,37,3,13,79,132
E00074264,0,52,7,8,99,166
E00074265,0,46,2,10,87,145
E00074266,0,37,0,28,58,123
E00074267,0,34,6,15,57,112
E00074268,0,45,7,22,68,142
E00074269,0,43,2,20,66,131
E00074270,0,37,2,17,73,129
E00074271,0,79,6,69,37,191
E00074272,0,43,12,25,45,125
E00074273,0,40,7,27,52,126
E00074274,3,49,14,22,40,128
E00074275,0,49,3,18,87,157
E00074276,2,48,14,26,57,147
E00074277,0,32,1,10,82,125
E00074278,0,36,0,18,65,119
E00074279,0,61,9,25,89,184
E00074280,0,48,2,20,50,120
E00074281,0,45,2,10,57,114
E00074282,0,48,0,9,79,136
E00074283,0,47,1,18,61,127
E00074284,0,40,4,31,43,118
E00074285,0,42,0,14,58,114
E00074286,0,45,11,26,41,123
E00074287,0,43,16,37,43,139
E00074288,0,54,6,13,76,149
E00074289,1,45,1,14,53,114
E00074290,1,50,12,21,36,120
E00074291,0,47,5,22,47,121
E00074292,0,57,1,13,54,125
E00074293,1,54,3,30,58,146
E00074294,0,38,17,42,34,131
E00074295,2,54,10,23,44,133
E00074296,0,36,2,18,80,136
E00074297,0,52,5,12,88,157
E00074298,1,34,12,41,49,137
E00074299,0,41,8,26,51,126
E00074300,0,54,2,18,76,150
E00074301,0,36,2,12,81,131
E00074302,1,31,5,20,68,125
E00074303,0,35,0,7,71,113
E00074304,0,25,0,4,91,120
E00074306,0,30,1,9,80,120
E00074307,0,45,0,4,84,133
E00074308,0,33,0,8,79,120
E00074309,0,32,0,5,83,120
E00074310,0,43,0,2,73,118
E00074311,0,33,6,6,71,116
E00074312,0,36,0,7,79,122
E00074314,0,28,3,9,85,125
E00074315,0,34,2,6,95,137
E00074316,0,39,0,10,89,138
E00074317,0,27,0,7,98,132
E00074318,0,39,5,6,81,131
E00074319,0,33,0,9,89,131
E00074320,0,39,1,11,85,136
E00074321,0,36,0,3,82,121
E00074322,0,39,2,4,97,142
E00074323,0,36,1,6,87,130
E00074324,0,29,0,10,88,127
E00074325,0,35,6,12,69,122
E00074326,0,32,2,12,58,104
E00074327,0,81,0,15,50,146
E00074328,0,35,0,2,90,127
E00074329,0,32,0,2,85,119
E00074330,0,44,1,18,57,120
E00074331,0,34,0,7,81,122
E00074332,0,34,0,6,87,127
E00074333,0,41,1,4,81,127
E00074334,0,43,0,4,88,135
E00074335,0,35,1,7,82,125
E00074336,0,31,3,19,80,133
E00074337,0,37,0,18,71,126
E00074338,0,46,0,10,73,129
E00074339,0,44,5,13,74,136
E00074340,0,54,0,14,68,136
E00074341,0,23,2,9,98,132
E00074342,0,36,0,10,94,140
E00074343,1,45,9,21,51,127
E00074344,2,39,1,12,57,111
E00074345,0,42,0,4,66,112
E00074346,0,40,0,11,71,122
E00074347,0,37,5,4,77,123
E00074348,0,51,8,27,34,120
E00074349,0,39,11,12,74,136
E00074350,0,31,3,25,71,130
E00074351,0,43,0,18,63,124
E00074352,0,23,0,10,93,126
E00074353,0,32,1,8,94,135
E00074354,1,32,2,10,94,139
E00074355,0,31,0,3,81,115
E00074356,0,32,2,6,79,119
E00074357,0,35,1,7,89,132
E00074358,0,28,1,9,88,126
E00074359,1,28,2,14,75,120
E00074360,0,29,0,4,90,123
E00074361,0,30,1,6,83,120
E00074362,0,37,0,6,83,126
E00074363,0,47,0,11,65,123
E00074364,0,42,12,33,37,124
E00074365,0,47,0,21,60,128
E00074366,2,53,3,30,47,135
E00074367,2,55,27,31,37,152
E00074368,0,33,7,20,75,135
E00074369,0,50,6,23,40,119
E00074371,1,36,11,29,36,113
E00074372,2,53,17,25,39,136
E00074373,0,53,2,23,66,144
E00074374,0,49,9,26,33,117
E00074375,2,49,15,44,40,150
E00074376,0,62,1,19,54,136
E00074377,0,55,18,43,45,161
E00074378,0,42,1,19,66,128
E00074379,0,47,1,19,61,128
E00074380,0,37,4,8,71,120
E00074381,0,25,0,19,60,104
E00074382,0,49,1,17,60,127
E00074383,0,45,17,21,34,117
E00074384,0,41,10,28,31,110
E00074385,0,35,14,37,35,121
E00074386,0,47,0,18,68,133
E00074387,1,29,12,34,43,119
E00074388,0,36,0,13,61,110
E00074389,1,38,15,32,39,125
E00074390,0,30,16,43,17,106
E00074391,4,40,13,38,24,119
E00074392,0,48,21,34,30,133
E00074393,1,42,23,37,35,138
E00074394,3,38,16,37,28,122
E00074395,1,45,15,28,39,128
E00074396,0,43,1,12,74,130
E00074397,1,51,13,34,37,136
E00074398,0,54,1,11,67,133
E00074399,0,39,4,8,93,144
E00074400,0,60,10,39,72,181
E00074401,0,36,1,14,110,161
E00074402,0,34,5,5,118,162
E00074403,0,43,1,10,113,167
E00074404,1,42,1,16,88,148
E00074405,0,54,3,21,83,161
E00074406,0,67,6,41,65,179
E00074407,1,69,5,35,97,207
E00074408,0,53,7,30,86,176
E00074411,0,62,9,30,128,229
E00074412,0,39,14,29,38,120
E00074413,0,52,3,13,93,161
E00074414,0,49,3,14,80,146
E00074415,2,33,9,15,91,150
E00074416,0,32,4,15,91,142
E00074417,2,40,5,16,92,155
E00074418,0,33,7,14,74,128
E00074419,0,38,1,16,83,138
E00074420,2,44,7,17,97,167
E00074421,0,42,6,17,77,142
E00074422,0,56,7,26,55,144
E00074423,0,36,1,9,107,153
E00074424,0,50,0,12,67,129
E00074425,0,45,1,10,73,129
E00074426,0,32,2,11,94,139
E00074427,1,46,4,14,100,165
E00074428,0,34,0,11,107,152
E00074429,0,38,2,11,94,145
E00074430,0,50,4,17,86,157
E00074431,1,49,10,16,108,184
E00074432,0,33,3,8,98,142
E00074433,0,29,1,6,95,131
E00074434,0,44,7,18,68,137
E00074435,0,29,2,15,98,144
E00074436,0,51,6,12,87,156
E00074437,0,34,4,19,82,139
E00074438,0,39,2,16,102,159
E00074439,0,33,13,23,42,111
E00165771,1,67,13,48,70,199
E00165772,0,21,2,1,38,62
E00174043,0,24,0,4,63,91
E00174044,0,50,6,34,48,138
E00174046,0,36,1,6,66,109
E00174053,1,54,11,26,65,157
E00174058,0,52,10,19,66,147
E00174214,0,52,6,10,72,140
E00174215,0,38,5,32,53,128
E00174218,1,55,1,16,128,201
E00174220,0,17,1,1,35,54
E00174221,0,48,7,14,63,132
E00174225,0,37,0,5,45,87
E00174226,0,42,2,17,72,133
E00174228,0,55,13,18,45,131
E00174229,0,55,19,35,68,177
E00174231,0,73,3,31,51,158
E00174232,0,43,6,18,82,149
E00174234,0,68,5,17,121,211
E00174237,1,43,11,22,62,139
E00174239,1,15,6,12,14,48
E00174243,1,59,2,8,115,185
E00174245,0,33,2,7,57,99
E00174246,2,25,9,19,43,98
E00174248,0,23,2,5,71,101
E00174249,0,35,10,8,56,109
E00174251,1,80,14,42,96,233
E00174253,0,45,6,22,67,140
E00174254,0,36,12,39,25,112
E00174256,0,47,4,10,103,164
E00174257,0,41,3,22,132,198
E00174259,0,36,8,19,72,135
E00174260,0,28,10,18,34,90
E00174262,3,44,4,16,75,142
E00174263,0,26,3,8,64,101
E00174273,0,54,12,32,52,150
E00174275,0,16,2,7,60,85
E00174276,0,33,9,13,68,123
E00174277,0,40,6,15,102,163
E00174278,0,53,1,6,182,242
E00174279,0,37,9,21,43,110
E00174280,1,45,5,18,38,107
E00174281,1,31,5,14,68,119
E00174282,1,78,5,16,116,216
E00174283,0,43,9,19,84,155
E00174284,0,43,5,13,93,154
E00174286,0,21,2,9,81,113
E00174287,1,34,0,5,73,113
E00174288,0,40,6,21,56,123
E00174289,0,48,3,22,49,122
E00174290,0,35,19,35,34,123
E00174291,0,45,2,12,86,145
E00174292,1,31,1,13,113,159
E00174293,0,46,1,13,100,160
E00174294,0,43,1,8,71,123
E00174295,0,47,0,3,62,112
E00174296,0,67,5,26,115,213
E00174298,0,21,2,7,19,49
E00174299,0,55,6,17,99,177
E00174300,0,36,0,10,90,136
E00174302,0,27,4,15,39,85
E00174303,0,19,1,2,95,117
E00174304,0,29,11,27,43,110
E00174305,1,34,11,26,22,94
E00174306,3,38,7,32,24,104
E00174307,0,39,1,4,49,93
E00174309,0,19,0,4,74,97
E00174311,0,20,0,3,77,100
E00174312,0,30,0,9,48,87
E00174313,0,25,1,6,64,96
E00174314,0,50,9,48,26,133
E00174315,0,43,3,14,96,156
E00174316,0,21,1,3,60,85
E00174317,0,23,0,2,43,68
E00174318,0,15,1,3,30,49
E00174319,0,32,9,34,31,106
E00174320,1,36,15,19,55,126
E00174321,0,22,2,5,14,43
E00174322,2,31,15,23,18,89
E00174323,2,17,1,7,25,52
E00174324,2,34,6,21,43,106
E00174325,0,59,1,14,119,193
E00174326,0,57,16,36,75,184
E00174327,0,42,4,14,90,150
E00174328,0,28,6,14,45,93
E00174329,1,38,7,19,63,128
E00174331,0,8,0,3,30,41
E00174332,0,26,0,7,70,103
E00174333,0,23,0,5,82,110
E00178043,0,42,8,14,65,129
E00178044,1,24,1,2,70,98
E00178045,1,39,3,14,44,101
E00178046,0,76,1,13,100,190
E00178047,0,25,0,16,69,110
E00178048,0,23,0,9,70,102
E00178049,0,58,1,8,81,148
E00178050,0,52,12,32,20,116
E00178051,12,47,32,52,45,188
E00178052,0,32,3,11,64,110
E00178053,0,33,0,4,144,181
E00178054,0,22,6,15,50,93
E00178055,0,17,1,6,44,68
E00178056,0,48,0,13,45,106
E00178057,0,40,0,7,130,177
E00178058,0,15,0,3,45,63
E00178059,4,52,8,21,93,178
E00178060,0,43,3,14,165,225
E00178061,0,39,10,12,129,190
E00178062,0,30,4,14,83,131
E00178063,0,15,1,5,20,41
E00178064,0,15,0,2,35,52
E00178065,0,22,1,3,71,97
E00178066,0,75,3,22,106,206
E00178067,0,34,4,20,47,105
E00178068,0,20,2,5,21,48
E00178069,0,31,3,5,174,213
E00178070,0,50,3,16,55,124
E00178071,0,25,7,14,57,103
E00178072,0,36,0,11,107,154
E00178073,0,22,1,4,88,115
E00178074,0,42,0,11,73,126
E00178075,0,11,0,10,44,65
E00178076,0,78,3,14,104,199
E00178077,0,17,0,3,27,47
E00178078,0,35,10,31,10,86
E00178079,0,47,1,15,162,225
E00178080,1,64,13,56,35,169
E00178081,0,25,10,22,30,87
E00178082,0,28,6,17,74,125
E00178083,1,41,4,12,66,124
E00178084,0,80,1,10,263,354
E00178085,0,23,2,3,22,50
E00178086,0,42,0,10,133,185
E00178087,1,55,6,36,53,151
E00178088,0,10,0,2,55,67
E00178089,2,64,20,38,39,163
E00178090,1,32,3,8,53,97
E00178091,2,49,8,20,67,146
E00178092,1,59,4,18,88,170
E00178093,0,21,3,3,64,91
E00178094,2,32,7,16,32,89
E00178095,0,14,3,10,39,66
E00178096,0,42,1,7,46,96
E00178097,0,18,1,5,55,79
E00178098,1,32,8,20,49,110
E00178099,0,31,0,8,49,88
E00178100,0,21,2,4,64,91
E00178101,0,36,0,7,83,126
E00178102,0,49,7,30,46,132
E00178103,0,25,0,1,116,142
E00178104,1,36,8,24,36,105
E00178105,0,24,3,5,48,80
E00178106,0,25,1,12,60,98
E00178107,0,19,0,4,50,73
E00178108,0,65,4,24,122,215
E00178109,0,26,1,2,84,113
E00178110,0,14,1,6,77,98
E00178111,0,19,0,4,21,44
E00178112,0,56,0,7,174,237
E00178113,0,34,6,27,36,103
E00178114,0,33,0,4,92,129
E00178115,0,5,1,3,74,83
E00178116,1,22,8,15,11,57
E00178117,0,54,7,15,170,246
E00178118,0,22,4,6,120,152
E00178119,1,43,10,25,46,125
